chrom	position	ref	var	normal_reads1	normal_reads2	normal_var_freq	normal_gt	tumor_reads1	tumor_reads2	tumor_var_freq	tumor_gt	somatic_status	variant_p_value	somatic_p_value	tumor_reads1_plus	tumor_reads1_minus	tumor_reads2_plus	tumor_reads2_minus	normal_reads1_plus	normal_reads1_minus	normal_reads2_plus	normal_reads2_minus
1	14930	A	G	8	0	0%	A	5	4	44.44%	R	Somatic	1.0	0.0529411764705883	2	3	1	3	4	4	0	0
1	29153	G	A	10	0	0%	G	7	2	22.22%	R	Somatic	1.0	0.2105263157894756	4	3	1	1	6	4	0	0
1	29155	A	G	10	0	0%	A	7	2	22.22%	R	Somatic	1.0	0.2105263157894756	4	3	1	1	7	3	0	0
1	1004145	A	G	8	0	0%	A	8	2	20%	R	Somatic	1.0	0.2941176470588277	2	6	1	1	1	7	0	0
1	1318098	C	A	14	0	0%	C	7	2	22.22%	M	Somatic	1.0	0.1422924901185766	3	4	0	2	4	10	0	0
1	1413813	A	G	38	1	2.56%	A	13	4	23.53%	R	Somatic	1.0	0.0259195730893841	4	9	4	0	20	18	1	0
1	1588670	G	A	39	7	15.22%	G	113	70	38.25%	R	Somatic	1.0	0.0018550211735921	77	36	55	15	36	3	5	2
1	1588717	G	A	63	9	12.5%	G	174	81	31.76%	R	Somatic	1.0	0.0005962833087843351	115	59	53	28	56	7	7	2
1	1588737	C	T	71	8	10.13%	C	203	73	26.45%	Y	Somatic	1.0	0.0011047084295425	138	65	41	32	62	9	5	3
1	1660907	C	T	25	0	0%	C	6	2	25%	Y	Somatic	1.0	0.0530303030303037	0	6	0	2	6	19	0	0
1	2450887	A	G	24	0	0%	A	8	2	20%	R	Somatic	1.0	0.0802139037433123	1	7	0	2	4	20	0	0
1	2776080	A	G	8	0	0%	A	7	5	41.67%	R	Somatic	1.0	0.0510835913312693	5	2	3	2	4	4	0	0
1	3418578	T	C	159	2	1.24%	T	68	24	26.09%	Y	Somatic	1.0	5.424861810812284e-10	12	56	12	12	12	147	2	0
1	3418615	G	C	12	0	0%	G	11	3	21.43%	S	Somatic	1.0	0.1400000000000002	5	6	2	1	3	9	0	0
1	3500068	G	A	34	1	2.86%	G	5	3	37.5%	R	Somatic	1.0	0.0164492342597844	2	3	0	3	22	12	0	1
1	3789211	A	G	51	0	0%	A	60	18	23.08%	R	Somatic	1.0	4.823103866521398e-05	2	58	0	18	3	48	0	0
1	3789212	T	C	50	0	0%	T	55	21	27.63%	Y	Somatic	1.0	6.769915774955282e-06	2	53	3	18	3	47	0	0
1	3789229	C	T	50	0	0%	C	49	16	24.62%	Y	Somatic	1.0	4.3260273325849823e-05	0	49	1	15	4	46	0	0
1	4204601	T	C	7	0	0%	T	15	12	44.44%	Y	Somatic	1.0	0.031701890989988	5	10	7	5	5	2	0	0
1	4204604	C	T	8	0	0%	C	15	12	44.44%	Y	Somatic	1.0	0.0208326712219923	5	10	6	6	6	2	0	0
1	4204613	T	A	9	0	0%	T	12	13	52%	W	Somatic	1.0	0.0056038696194423	6	6	9	4	6	3	0	0
1	4204622	C	A	9	0	0%	C	21	9	30%	M	Somatic	1.0	0.0675135836925506	7	14	7	2	6	3	0	0
1	4204773	T	A	9	0	0%	T	11	5	31.25%	W	Somatic	1.0	0.0822134387351773	6	5	2	3	5	4	0	0
1	4204778	C	T	9	0	0%	C	8	4	33.33%	Y	Somatic	1.0	0.0827067669172936	5	3	1	3	4	5	0	0
1	4204786	A	T	10	0	0%	A	5	2	28.57%	W	Somatic	1.0	0.1544117647058832	4	1	0	2	5	5	0	0
1	11106367	G	A	22	0	0%	G	8	2	20%	R	Somatic	1.0	0.0907258064516143	8	0	2	0	21	1	0	0
1	11288758	G	A	48	0	0%	G	80	25	23.81%	R	Somatic	1.0	2.904103280481873e-05	75	5	22	3	43	5	0	0
1	13172948	G	C	11	0	0%	G	26	12	31.58%	S	Somatic	1.0	0.0293449550119828	13	13	8	4	2	9	0	0
1	13183578	G	C	9	0	0%	G	18	6	25%	S	Somatic	1.0	0.1215239154616251	6	12	0	6	3	6	0	0
1	16492707	A	G	11	0	0%	A	8	2	20%	R	Somatic	1.0	0.2142857142857145	5	3	0	2	7	4	0	0
1	16971106	C	T	11	0	0%	C	7	5	41.67%	Y	Somatic	1.0	0.0235371036286369	4	3	3	2	7	4	0	0
1	16974549	C	G	18	0	0%	C	6	2	25%	S	Somatic	1.0	0.0861538461538461	5	1	0	2	11	7	0	0
1	16984898	G	A	25	1	3.85%	G	7	5	41.67%	R	Somatic	1.0	0.007793729155958	4	3	3	2	16	9	1	0
1	17066825	G	A	8	0	0%	G	6	2	25%	R	Somatic	1.0	0.2333333333333349	0	6	0	2	3	5	0	0
1	17226809	T	C	9	0	0%	T	8	2	20%	Y	Somatic	1.0	0.2631578947368443	4	4	2	0	7	2	0	0
1	17226811	T	C	9	0	0%	T	8	2	20%	Y	Somatic	1.0	0.2631578947368443	4	4	2	0	6	3	0	0
1	17231508	T	C	8	0	0%	T	7	5	41.67%	Y	Somatic	1.0	0.0510835913312693	1	6	4	1	4	4	0	0
1	17231522	T	C	9	0	0%	T	7	5	41.67%	Y	Somatic	1.0	0.0389208314904912	2	5	4	1	4	5	0	0
1	17231540	G	A	8	0	0%	G	5	5	50%	R	Somatic	1.0	0.0294117647058824	2	3	5	0	3	5	0	0
1	17231546	G	A	8	0	0%	G	7	4	36.36%	R	Somatic	1.0	0.0851393188854487	4	3	3	1	3	5	0	0
1	17231557	G	A	8	0	0%	G	4	6	60%	R	Somatic	1.0	0.0113122171945702	4	0	4	2	2	6	0	0
1	17231567	T	C	8	0	0%	T	4	6	60%	Y	Somatic	1.0	0.0113122171945702	4	0	4	2	4	4	0	0
1	17231595	A	G	8	0	0%	A	4	5	55.56%	R	Somatic	1.0	0.0203619909502262	3	1	2	3	5	3	0	0
1	17231601	A	G	8	0	0%	A	4	5	55.56%	R	Somatic	1.0	0.0203619909502262	3	1	2	3	4	4	0	0
1	17231617	G	A	9	0	0%	G	5	4	44.44%	R	Somatic	1.0	0.0411764705882359	4	1	2	2	5	4	0	0
1	17231639	C	T	8	0	0%	C	4	6	60%	Y	Somatic	1.0	0.0113122171945702	2	2	3	3	5	3	0	0
1	17231646	G	T	8	0	0%	G	3	6	66.67%	K	Somatic	1.0	0.006787330316742	1	2	2	4	5	3	0	0
1	21900396	A	C	39	7	15.22%	A	33	20	37.74%	M	Somatic	1.0	0.0104010807293913	4	29	5	15	6	33	3	4
1	21900397	G	T	37	7	15.91%	G	33	19	36.54%	K	Somatic	1.0	0.0198066272647218	4	29	5	14	6	31	3	4
1	22332332	T	C	140	23	14.11%	T	120	35	22.58%	Y	Somatic	1.0	0.0349892652236293	62	58	32	3	39	101	21	2
1	23081408	G	A	8	0	0%	G	7	3	30%	R	Somatic	1.0	0.1470588235294125	3	4	1	2	6	2	0	0
1	23081429	G	A	9	0	0%	G	5	4	44.44%	R	Somatic	1.0	0.0411764705882359	3	2	2	2	8	1	0	0
1	24671482	C	T	46	0	0%	C	29	18	38.3%	Y	Somatic	1.0	6.273248571274646e-07	3	26	1	17	2	44	0	0
1	24671485	T	G	41	0	0%	T	28	17	37.78%	K	Somatic	1.0	2.771256248275005e-06	2	26	1	16	2	39	0	0
1	25656531	T	C	33	1	2.94%	T	46	15	24.59%	Y	Somatic	1.0	0.0047133025861492	45	1	15	0	33	0	1	0
1	29533601	C	T	7	1	12.5%	C	2	6	75%	T	Somatic	1.0	0.0202797202797201	0	2	1	5	1	6	0	1
1	30196372	A	T	12	0	0%	A	7	5	41.67%	W	Somatic	1.0	0.0186335403726707	3	4	4	1	6	6	0	0
1	30196396	T	C	11	0	0%	T	11	4	26.67%	Y	Somatic	1.0	0.0913043478260877	9	2	3	1	6	5	0	0
1	30196539	A	G	10	0	0%	A	8	2	20%	R	Somatic	1.0	0.2368421052631576	5	3	0	2	6	4	0	0
1	30196555	T	C	8	0	0%	T	7	2	22.22%	Y	Somatic	1.0	0.2647058823529424	3	4	1	1	6	2	0	0
1	31904634	T	G	20	0	0%	T	6	3	33.33%	K	Somatic	1.0	0.0229885057471268	4	2	3	0	14	6	0	0
1	31904715	T	G	49	3	5.77%	T	20	11	35.48%	K	Somatic	1.0	0.000782437608497623	12	8	5	6	29	20	2	1
1	31904724	C	G	35	8	18.6%	C	9	14	60.87%	S	Somatic	1.0	0.0007459276602886883	3	6	7	7	18	17	2	6
1	31904876	A	T	9	0	0%	A	6	2	25%	W	Somatic	1.0	0.2058823529411773	3	3	1	1	2	7	0	0
1	40557554	G	A	4	0	0%	G	5	3	37.5%	R	Somatic	1.0	0.2545454545454543	4	1	3	0	4	0	0	0
1	40811256	C	G	18	4	18.18%	C	5	10	66.67%	S	Somatic	1.0	0.0039587573898572	0	5	0	10	0	18	0	4
1	42011249	C	G	8	0	0%	C	6	3	33.33%	S	Somatic	1.0	0.1235294117647057	3	3	3	0	5	3	0	0
1	42011254	A	G	8	0	0%	A	7	3	30%	R	Somatic	1.0	0.1470588235294125	4	3	3	0	5	3	0	0
1	42011278	A	G	8	0	0%	A	8	4	33.33%	R	Somatic	1.0	0.1021671826625396	7	1	4	0	4	4	0	0
1	43672636	T	G	9	2	18.18%	T	10	13	56.52%	K	Somatic	1.0	0.0390109380793465	0	10	3	10	0	9	0	2
1	43787437	A	G	7	1	12.5%	A	3	6	66.67%	R	Somatic	1.0	0.0364047716988893	0	3	0	6	1	6	0	1
1	44451124	G	T	17	3	15%	G	12	11	47.83%	K	Somatic	1.0	0.0232455526538196	12	0	11	0	17	0	3	0
1	48208969	A	G	8	0	0%	A	11	3	21.43%	R	Somatic	1.0	0.2363636363636351	7	4	2	1	4	4	0	0
1	48848552	G	A	13	0	0%	G	7	2	22.22%	R	Somatic	1.0	0.1558441558441554	5	2	1	1	7	6	0	0
1	67487376	C	A	103	2	1.9%	C	77	29	27.36%	M	Somatic	1.0	3.789288046951784e-08	13	64	8	21	21	82	0	2
1	67487377	A	G	94	1	1.05%	A	69	29	29.59%	R	Somatic	1.0	4.704338417873457e-09	13	56	8	21	20	74	0	1
1	86563355	T	C	11	0	0%	T	6	3	33.33%	Y	Somatic	1.0	0.0736842105263166	1	5	2	1	2	9	0	0
1	86611702	T	C	7	1	12.5%	T	13	16	55.17%	Y	Somatic	1.0	0.0373966341708278	13	0	16	0	7	0	1	0
1	89652072	C	T	63	14	18.18%	C	236	94	28.48%	Y	Somatic	1.0	0.0415654828614613	98	138	33	61	21	42	6	8
1	102359081	A	T	9	0	0%	A	35	22	38.6%	W	Somatic	1.0	0.0191529688910626	22	13	13	9	5	4	0	0
1	108742882	G	T	33	0	0%	G	6	2	25%	K	Somatic	1.0	0.0341463414634155	1	5	0	2	4	29	0	0
1	113612829	G	A	9	0	0%	G	6	2	25%	R	Somatic	1.0	0.2058823529411773	6	0	2	0	4	5	0	0
1	121367959	T	C	8	0	0%	T	7	2	22.22%	Y	Somatic	1.0	0.2647058823529424	5	2	1	1	7	1	0	0
1	121367997	G	A	10	0	0%	G	7	2	22.22%	R	Somatic	1.0	0.2105263157894756	1	6	0	2	4	6	0	0
1	121368007	A	G	10	0	0%	A	7	2	22.22%	R	Somatic	1.0	0.2105263157894756	1	6	0	2	1	9	0	0
1	121368024	C	A	10	0	0%	C	6	2	25%	M	Somatic	1.0	0.1830065359477151	0	6	0	2	1	9	0	0
1	121404020	A	G	9	0	0%	A	7	3	30%	R	Somatic	1.0	0.1238390092879262	2	5	1	2	3	6	0	0
1	121481022	T	C	28	0	0%	T	8	2	20%	Y	Somatic	1.0	0.0640113798008536	0	8	1	1	2	26	0	0
1	142535845	G	A	10	0	0%	G	6	2	25%	R	Somatic	1.0	0.1830065359477151	4	2	2	0	8	2	0	0
1	142535859	C	T	10	0	0%	C	6	5	45.45%	Y	Somatic	1.0	0.0227038183694534	4	2	4	1	7	3	0	0
1	142535866	G	C	9	0	0%	G	12	3	20%	S	Somatic	1.0	0.224802371541498	8	4	1	2	6	3	0	0
1	142535873	G	A	9	0	0%	G	11	3	21.43%	R	Somatic	1.0	0.2055335968379435	7	4	1	2	4	5	0	0
1	142535953	G	C	9	0	0%	G	5	3	37.5%	S	Somatic	1.0	0.0823529411764703	2	3	1	2	6	3	0	0
1	142535960	G	A	8	0	0%	G	5	3	37.5%	R	Somatic	1.0	0.1000000000000002	2	3	0	3	6	2	0	0
1	142535961	T	A	8	0	0%	T	4	3	42.86%	W	Somatic	1.0	0.0769230769230769	2	2	0	3	6	2	0	0
1	142535968	G	A	8	0	0%	G	7	3	30%	R	Somatic	1.0	0.1470588235294125	3	4	0	3	6	2	0	0
1	142535975	A	G	8	0	0%	A	8	2	20%	R	Somatic	1.0	0.2941176470588277	4	4	0	2	7	1	0	0
1	142535976	G	T	5	0	0%	G	7	3	30%	K	Somatic	1.0	0.2637362637362642	4	3	0	3	4	1	0	0
1	142535978	G	A	9	0	0%	G	7	3	30%	R	Somatic	1.0	0.1238390092879262	2	5	2	1	7	2	0	0
1	142535989	G	C	9	0	0%	G	5	2	28.57%	S	Somatic	1.0	0.1750000000000013	3	2	2	0	7	2	0	0
1	142535991	A	G	9	0	0%	A	4	2	33.33%	R	Somatic	1.0	0.1428571428571436	2	2	2	0	7	2	0	0
1	142537184	G	T	11	0	0%	G	6	2	25%	K	Somatic	1.0	0.1637426900584798	4	2	2	0	6	5	0	0
1	142537208	T	G	10	0	0%	T	7	3	30%	K	Somatic	1.0	0.1052631578947376	4	3	1	2	3	7	0	0
1	142537245	A	G	10	0	0%	A	5	5	50%	R	Somatic	1.0	0.0162538699690402	2	3	3	2	2	8	0	0
1	142537249	A	T	10	0	0%	A	5	4	44.44%	W	Somatic	1.0	0.0325077399380805	2	3	2	2	2	8	0	0
1	142537264	A	C	10	0	0%	A	4	4	50%	M	Somatic	1.0	0.0228758169934642	0	4	3	1	2	8	0	0
1	142537378	C	G	11	0	0%	C	6	2	25%	S	Somatic	1.0	0.1637426900584798	5	1	1	1	7	4	0	0
1	142537444	T	G	15	0	0%	T	7	5	41.67%	K	Somatic	1.0	0.0098104793756967	4	3	3	2	6	9	0	0
1	142537445	G	T	16	0	0%	G	7	5	41.67%	K	Somatic	1.0	0.008058608058608	3	4	3	2	7	9	0	0
1	142537452	A	G	15	0	0%	A	8	5	38.46%	R	Somatic	1.0	0.0130952380952382	4	4	3	2	5	10	0	0
1	142537459	A	T	14	0	0%	A	8	5	38.46%	W	Somatic	1.0	0.0159420289855072	4	4	4	1	6	8	0	0
1	142537490	A	G	12	0	0%	A	8	7	46.67%	R	Somatic	1.0	0.0072463768115941	2	6	5	2	7	5	0	0
1	142537521	A	G	16	0	0%	A	14	4	22.22%	R	Somatic	1.0	0.065982404692082	8	6	3	1	9	7	0	0
1	142537528	T	G	16	0	0%	T	13	5	27.78%	K	Somatic	1.0	0.0307917888563047	7	6	5	0	10	6	0	0
1	142537541	A	G	14	0	0%	A	13	5	27.78%	R	Somatic	1.0	0.0425472747497227	7	6	4	1	9	5	0	0
1	142537542	A	C	14	0	0%	A	7	11	61.11%	M	Somatic	1.0	0.0002466508681143263	4	3	7	4	9	5	0	0
1	142537551	A	C	15	0	0%	A	10	6	37.5%	M	Somatic	1.0	0.010876282288963	6	4	2	4	10	5	0	0
1	142537557	T	C	16	0	0%	T	13	4	23.53%	Y	Somatic	1.0	0.0581622678396872	6	7	2	2	10	6	0	0
1	142537573	T	G	21	1	4.55%	T	8	6	42.86%	K	Somatic	1.0	0.0083254269449713	4	4	0	6	13	8	1	0
1	142537574	G	A	21	1	4.55%	G	7	7	50%	R	Somatic	1.0	0.0025943859189949	3	4	2	5	12	9	1	0
1	142537608	G	C	32	0	0%	G	13	4	23.53%	S	Somatic	1.0	0.0112329853310426	6	7	1	3	16	16	0	0
1	142537621	T	A	23	0	0%	T	7	2	22.22%	W	Somatic	1.0	0.0725806451612905	1	6	0	2	12	11	0	0
1	142537638	G	A	25	0	0%	G	7	3	30%	R	Somatic	1.0	0.0183346065699006	1	6	0	3	15	10	0	0
1	142537643	C	G	26	0	0%	C	5	4	44.44%	S	Somatic	1.0	0.0024064171122994	0	5	1	3	16	10	0	0
1	142537648	G	C	26	0	0%	G	6	4	40%	S	Somatic	1.0	0.0035650623885917	1	5	1	3	14	12	0	0
1	142537670	A	G	32	0	0%	A	10	4	28.57%	R	Somatic	1.0	0.00613414223121	5	5	1	3	12	20	0	0
1	142537720	T	G	27	0	0%	T	7	2	22.22%	K	Somatic	1.0	0.0571428571428573	5	2	0	2	12	15	0	0
1	142537724	C	A	28	0	0%	C	6	2	25%	M	Somatic	1.0	0.0444444444444439	6	0	0	2	14	14	0	0
1	142537899	T	A	22	0	0%	T	6	3	33.33%	W	Somatic	1.0	0.018687430478309	2	4	2	1	10	12	0	0
1	142537918	T	G	18	0	0%	T	7	2	22.22%	K	Somatic	1.0	0.1025641025641025	2	5	1	1	10	8	0	0
1	142537943	A	C	13	0	0%	A	5	4	44.44%	M	Somatic	1.0	0.0172248803827749	1	4	4	0	5	8	0	0
1	142537969	T	G	10	2	16.67%	T	4	6	60%	K	Somatic	1.0	0.0479876160990718	1	3	5	1	5	5	1	1
1	142537971	C	G	12	0	0%	C	6	3	33.33%	S	Somatic	1.0	0.0631578947368422	2	4	3	0	6	6	0	0
1	142537977	G	A	10	0	0%	G	8	2	20%	R	Somatic	1.0	0.2368421052631576	4	4	2	0	5	5	0	0
1	142537980	A	G	9	0	0%	A	7	3	30%	R	Somatic	1.0	0.1238390092879262	5	2	2	1	5	4	0	0
1	142537983	A	G	8	0	0%	A	8	2	20%	R	Somatic	1.0	0.2941176470588277	5	3	2	0	4	4	0	0
1	142538004	A	G	9	0	0%	A	4	4	50%	R	Somatic	1.0	0.0294117647058824	2	2	2	2	3	6	0	0
1	142538006	T	G	7	0	0%	T	4	4	50%	K	Somatic	1.0	0.0512820512820511	2	2	2	2	2	5	0	0
1	142538017	C	T	8	0	0%	C	6	3	33.33%	Y	Somatic	1.0	0.1235294117647057	5	1	0	3	3	5	0	0
1	142538020	A	G	11	0	0%	A	6	2	25%	R	Somatic	1.0	0.1637426900584798	3	3	1	1	5	6	0	0
1	142538021	G	T	12	0	0%	G	8	2	20%	K	Somatic	1.0	0.1948051948051969	6	2	0	2	5	7	0	0
1	142538024	G	T	13	0	0%	G	8	2	20%	K	Somatic	1.0	0.1778656126482181	5	3	0	2	6	7	0	0
1	142538029	G	C	14	0	0%	G	7	3	30%	S	Somatic	1.0	0.0592885375494061	4	3	1	2	6	8	0	0
1	142538089	T	C	17	0	0%	T	2	6	75%	C	Somatic	1.0	0.00015810276679841778	0	2	3	3	13	4	0	0
1	142538105	A	G	20	0	0%	A	2	6	75%	G	Somatic	1.0	7.432181345224841e-05	0	2	2	4	14	6	0	0
1	142538110	G	T	20	0	0%	G	4	4	50%	K	Somatic	1.0	0.0034188034188034	0	4	2	2	14	6	0	0
1	142538295	G	C	13	0	0%	G	10	5	33.33%	S	Somatic	1.0	0.0305555555555561	6	4	1	4	6	7	0	0
1	142538298	G	A	15	0	0%	G	10	5	33.33%	R	Somatic	1.0	0.0210727969348661	6	4	1	4	7	8	0	0
1	142538352	G	A	13	0	0%	G	9	4	30.77%	R	Somatic	1.0	0.0478260869565216	5	4	2	2	5	8	0	0
1	142538385	T	G	12	0	0%	T	6	4	40%	K	Somatic	1.0	0.0287081339712921	2	4	3	1	6	6	0	0
1	142538636	A	G	26	0	0%	A	8	4	33.33%	R	Somatic	1.0	0.0067059540743753	6	2	4	0	17	9	0	0
1	142538639	G	C	27	0	0%	G	7	4	36.36%	S	Somatic	1.0	0.0044706360495835	4	3	4	0	17	10	0	0
1	142538644	T	G	26	1	3.7%	T	6	7	53.85%	K	Somatic	1.0	0.0006191950464396271	4	2	6	1	18	8	0	1
1	142538650	A	G	26	0	0%	A	8	6	42.86%	R	Somatic	1.0	0.0007823613086770923	5	3	3	3	17	9	0	0
1	142538660	G	C	29	0	0%	G	9	6	40%	S	Somatic	1.0	0.0007090187180941767	6	3	4	2	19	10	0	0
1	142538664	G	A	30	0	0%	G	11	5	31.25%	R	Somatic	1.0	0.0031865673928362	8	3	3	2	21	9	0	0
1	142538675	C	G	30	5	14.29%	C	9	8	47.06%	S	Somatic	1.0	0.014644640605561	6	3	4	4	19	11	5	0
1	142538678	T	G	35	0	0%	T	13	5	27.78%	K	Somatic	1.0	0.0029856935517313	9	4	1	4	23	12	0	0
1	142538743	A	G	34	0	0%	A	13	5	27.78%	R	Somatic	1.0	0.0032967032967033	8	5	0	5	13	21	0	0
1	142538752	C	T	33	0	0%	C	15	4	21.05%	Y	Somatic	1.0	0.0143171114599681	10	5	0	4	13	20	0	0
1	142538828	C	G	18	0	0%	C	11	3	21.43%	S	Somatic	1.0	0.0733870967741949	8	3	2	1	7	11	0	0
1	142538841	G	A	17	0	0%	G	11	3	21.43%	R	Somatic	1.0	0.0809788654060054	8	3	2	1	6	11	0	0
1	142538844	T	C	17	0	0%	T	11	3	21.43%	Y	Somatic	1.0	0.0809788654060054	8	3	2	1	6	11	0	0
1	142538850	A	T	8	0	0%	A	4	3	42.86%	W	Somatic	1.0	0.0769230769230769	2	2	2	1	3	5	0	0
1	142538864	T	A	10	0	0%	T	6	2	25%	W	Somatic	1.0	0.1830065359477151	6	0	1	1	4	6	0	0
1	142538866	G	A	8	0	0%	G	6	2	25%	R	Somatic	1.0	0.2333333333333349	6	0	1	1	4	4	0	0
1	142538868	G	T	8	0	0%	G	6	2	25%	K	Somatic	1.0	0.2333333333333349	5	1	2	0	5	3	0	0
1	142538870	G	T	7	0	0%	G	7	2	22.22%	K	Somatic	1.0	0.3000000000000021	6	1	2	0	5	2	0	0
1	142785694	C	T	7	0	0%	C	5	5	50%	Y	Somatic	1.0	0.0407239819004527	3	2	0	5	2	5	0	0
1	142809535	G	C	8	0	0%	G	8	3	27.27%	S	Somatic	1.0	0.1702786377708978	3	5	2	1	5	3	0	0
1	142814984	C	T	8	0	0%	C	7	2	22.22%	Y	Somatic	1.0	0.2647058823529424	6	1	2	0	4	4	0	0
1	143270492	G	A	12	3	20%	R	4	10	71.43%	R	Somatic	1.0	0.0072948046100789	1	3	4	6	8	4	2	1
1	143270552	G	A	15	0	0%	G	6	3	33.33%	R	Somatic	1.0	0.0415019762845845	2	4	1	2	6	9	0	0
1	143283390	C	A	38	0	0%	C	22	7	24.14%	M	Somatic	1.0	0.0017947257128138	1	21	2	5	4	34	0	0
1	143352874	A	C	9	0	0%	A	6	3	33.33%	M	Somatic	1.0	0.1029411764705892	4	2	1	2	6	3	0	0
1	143403689	T	C	11	0	0%	T	47	16	25.4%	Y	Somatic	1.0	0.0544741546342799	3	44	1	15	0	11	0	0
1	144519860	T	C	32	4	11.11%	T	25	12	32.43%	Y	Somatic	1.0	0.0263202428981955	25	0	12	0	32	0	4	0
1	145017723	T	G	16	3	15.79%	T	5	10	66.67%	K	Somatic	1.0	0.0033966887523979	3	2	6	4	13	3	2	1
1	145034453	C	T	10	2	16.67%	C	4	6	60%	Y	Somatic	1.0	0.0479876160990718	0	4	3	3	7	3	2	0
1	145038215	C	T	8	0	0%	C	6	3	33.33%	Y	Somatic	1.0	0.1235294117647057	3	3	0	3	3	5	0	0
1	145112414	T	C	136	27	16.56%	T	447	143	24.24%	Y	Somatic	1.0	0.0224577387949369	212	235	66	77	35	101	9	18
1	145112428	C	T	125	23	15.54%	C	437	141	24.39%	Y	Somatic	1.0	0.0124510356831029	171	266	57	84	28	97	7	16
1	145284170	G	A	277	8	2.81%	G	144	70	32.71%	R	Somatic	1.0	7.762789550618418e-21	101	43	50	20	197	80	8	0
1	145295677	G	A	9	0	0%	G	15	6	28.57%	R	Somatic	1.0	0.0913881520778078	4	11	0	6	0	9	0	0
1	145352463	T	C	6	0	0%	T	10	3	23.08%	Y	Somatic	1.0	0.2951496388028878	4	6	2	1	2	4	0	0
1	146049019	C	T	23	3	11.54%	C	36	19	34.55%	Y	Somatic	1.0	0.0246525649276945	20	16	14	5	19	4	3	0
1	146522722	T	C	15	3	16.67%	T	39	33	45.83%	Y	Somatic	1.0	0.0202858275312678	21	18	12	21	5	10	2	1
1	147931332	G	A	27	0	0%	G	8	2	20%	R	Somatic	1.0	0.0675675675675685	5	3	1	1	17	10	0	0
1	148859415	A	G	8	0	0%	A	5	3	37.5%	R	Somatic	1.0	0.1000000000000002	4	1	0	3	7	1	0	0
1	148901835	C	T	16	0	0%	C	7	3	30%	Y	Somatic	1.0	0.0461538461538456	7	0	3	0	12	4	0	0
1	148903313	T	C	106	19	15.2%	T	109	36	24.83%	Y	Somatic	1.0	0.0346614719295587	91	18	29	7	82	24	14	5
1	148928050	A	T	11	0	0%	A	6	4	40%	W	Somatic	1.0	0.0350877192982459	4	2	4	0	9	2	0	0
1	148928098	C	T	9	0	0%	C	5	3	37.5%	Y	Somatic	1.0	0.0823529411764703	3	2	2	1	5	4	0	0
1	148928122	C	A	10	0	0%	C	6	2	25%	M	Somatic	1.0	0.1830065359477151	5	1	0	2	3	7	0	0
1	148928129	C	G	10	0	0%	C	6	2	25%	S	Somatic	1.0	0.1830065359477151	5	1	0	2	3	7	0	0
1	148928149	C	T	9	0	0%	C	7	4	36.36%	Y	Somatic	1.0	0.0681114551083591	4	3	0	4	1	8	0	0
1	148928156	C	G	10	0	0%	C	8	4	33.33%	S	Somatic	1.0	0.0676691729323312	4	4	0	4	2	8	0	0
1	148928172	C	A	12	0	0%	C	9	4	30.77%	M	Somatic	1.0	0.0565217391304345	6	3	0	4	4	8	0	0
1	148928199	A	G	11	0	0%	A	8	2	20%	R	Somatic	1.0	0.2142857142857145	4	4	0	2	6	5	0	0
1	149337591	C	T	17	0	0%	C	6	2	25%	Y	Somatic	1.0	0.0933333333333325	4	2	2	0	12	5	0	0
1	150305863	C	A	32	5	13.51%	C	9	8	47.06%	M	Somatic	1.0	0.0111550814962367	1	8	0	8	0	32	1	4
1	152276459	C	T	55	10	15.38%	C	103	43	29.45%	Y	Somatic	1.0	0.0202976469987991	28	75	7	36	8	47	1	9
1	152800128	C	T	20	3	13.04%	C	23	14	37.84%	Y	Somatic	1.0	0.0348555935559422	10	13	2	12	14	6	1	2
1	155580061	G	A	82	10	10.87%	G	14	9	39.13%	R	Somatic	1.0	0.0028971358515961	0	14	1	8	4	78	1	9
1	160681653	G	A	8	0	0%	G	11	3	21.43%	R	Somatic	1.0	0.2363636363636351	1	10	0	3	0	8	0	0
1	161440069	G	C	45	11	19.64%	G	19	14	42.42%	S	Somatic	1.0	0.0202229405483203	12	7	9	5	30	15	7	4
1	162760325	T	G	11	0	0%	T	7	3	30%	K	Somatic	1.0	0.0902255639097742	7	0	3	0	10	1	0	0
1	168511321	C	T	8	0	0%	C	20	8	28.57%	Y	Somatic	1.0	0.1027121638421772	1	19	0	8	0	8	0	0
1	170339203	C	A	22	5	18.52%	C	109	68	38.42%	M	Somatic	1.0	0.0326923475521175	72	37	49	19	16	6	3	2
1	175097331	G	A	34	8	19.05%	G	54	57	51.35%	R	Somatic	1.0	0.00021297592414203835	29	25	28	29	15	19	1	7
1	196884290	T	A	8	0	0%	T	38	18	32.14%	W	Somatic	1.0	0.0589523421077934	2	36	0	18	1	7	0	0
1	200593557	C	T	34	0	0%	C	51	13	20.31%	Y	Somatic	1.0	0.0024445914392327	3	48	0	13	3	31	0	0
1	201179274	T	G	31	1	3.12%	T	28	8	22.22%	K	Somatic	1.0	0.0215599179386801	16	12	7	1	14	17	0	1
1	203017915	T	G	20	0	0%	T	8	2	20%	K	Somatic	1.0	0.1034482758620701	4	4	0	2	5	15	0	0
1	205798033	G	A	13	3	18.75%	G	6	9	60%	R	Somatic	1.0	0.0225725846754042	0	6	1	8	0	13	0	3
1	211545344	A	G	13	2	13.33%	A	32	32	50%	R	Somatic	1.0	0.0087125511473946	28	4	30	2	12	1	2	0
1	212763530	T	G	13	2	13.33%	T	66	53	44.54%	K	Somatic	1.0	0.0170362898713322	10	56	7	46	1	12	0	2
1	214656668	G	C	33	5	13.16%	G	53	44	45.36%	S	Somatic	1.0	0.0002787436839662152	33	20	11	33	30	3	0	5
1	214656669	C	T	33	5	13.16%	C	53	44	45.36%	Y	Somatic	1.0	0.0002787436839662152	34	19	11	33	30	3	0	5
1	214656740	A	G	35	2	5.41%	A	50	20	28.57%	R	Somatic	1.0	0.0031737296771841	10	40	0	20	18	17	0	2
1	219783279	T	A	11	2	15.38%	T	19	17	47.22%	W	Somatic	1.0	0.0422868828240476	10	9	6	11	8	3	1	1
1	220142023	C	T	13	3	18.75%	C	38	33	46.48%	Y	Somatic	1.0	0.0366132864493167	35	3	32	1	13	0	3	0
1	224135764	G	A	24	1	4%	G	45	12	21.05%	R	Somatic	1.0	0.0451246512724003	24	21	4	8	7	17	1	0
1	227148060	G	A	15	0	0%	G	9	3	25%	R	Somatic	1.0	0.0752136752136758	3	6	2	1	6	9	0	0
1	227148074	G	A	11	0	0%	G	13	4	23.53%	R	Somatic	1.0	0.1162393162393164	4	9	2	2	3	8	0	0
1	227148096	G	A	8	0	0%	G	7	2	22.22%	R	Somatic	1.0	0.2647058823529424	3	4	0	2	3	5	0	0
1	227148159	A	G	8	2	20%	R	4	8	66.67%	R	Somatic	1.0	0.0379512128738138	3	1	5	3	3	5	1	1
1	227148195	G	C	12	0	0%	G	8	2	20%	S	Somatic	1.0	0.1948051948051969	3	5	1	1	6	6	0	0
1	227148222	G	A	13	0	0%	G	6	2	25%	R	Somatic	1.0	0.1333333333333354	4	2	0	2	7	6	0	0
1	227148238	T	G	10	1	9.09%	T	2	6	75%	G	Somatic	1.0	0.006271334444709	1	1	3	3	5	5	1	0
1	228767513	G	A	22	0	0%	G	9	3	25%	R	Somatic	1.0	0.0367647058823522	3	6	1	2	12	10	0	0
1	231337955	G	A	27	1	3.57%	G	22	8	26.67%	R	Somatic	1.0	0.0167331354316575	5	17	3	5	23	4	1	0
1	240308460	C	T	14	3	17.65%	C	15	17	53.12%	Y	Somatic	1.0	0.0160883174001525	12	3	15	2	12	2	3	0
1	248366702	G	A	9	0	0%	G	16	23	58.97%	R	Somatic	1.0	0.0012181544997042	3	13	8	15	1	8	0	0
2	209622	C	T	8	1	11.11%	C	3	5	62.5%	Y	Somatic	1.0	0.0429864253393665	1	2	4	1	7	1	1	0
2	427375	T	A	8	0	0%	T	4	4	50%	W	Somatic	1.0	0.0384615384615386	1	3	3	1	6	2	0	0
2	3061669	G	A	13	0	0%	G	11	3	21.43%	R	Somatic	1.0	0.1244444444444423	7	4	3	0	9	4	0	0
2	3319289	C	T	32	0	0%	C	12	3	20%	Y	Somatic	1.0	0.0280604378661738	4	8	0	3	11	21	0	0
2	3773145	C	A	52	7	11.86%	C	9	8	47.06%	M	Somatic	1.0	0.0033414255010679	2	7	3	5	6	46	2	5
2	9203118	A	T	8	0	0%	A	6	2	25%	W	Somatic	1.0	0.2333333333333349	4	2	2	0	5	3	0	0
2	10153189	G	A	15	0	0%	G	7	3	30%	R	Somatic	1.0	0.0521739130434784	3	4	2	1	9	6	0	0
2	10153191	G	T	14	0	0%	G	6	3	33.33%	K	Somatic	1.0	0.0474308300395256	2	4	2	1	8	6	0	0
2	10153221	G	A	10	1	9.09%	G	4	5	55.56%	R	Somatic	1.0	0.0379256965944274	1	3	3	2	2	8	1	0
2	10153223	A	G	10	1	9.09%	A	4	5	55.56%	R	Somatic	1.0	0.0379256965944274	1	3	3	2	2	8	1	0
2	10220551	A	G	17	0	0%	A	7	2	22.22%	R	Somatic	1.0	0.1107692307692308	3	4	0	2	11	6	0	0
2	11253697	C	T	8	0	0%	C	7	3	30%	Y	Somatic	1.0	0.1470588235294125	1	6	2	1	4	4	0	0
2	243152575	A	G	17	0	0%	A	13	5	27.78%	R	Somatic	1.0	0.0263929618768324	6	7	1	4	13	4	0	0
7	44368237	G	A	8	0	0%	G	10	4	28.57%	R	Somatic	1.0	0.1368421052631591	6	4	0	4	6	2	0	0
10	135524677	T	G	10	0	0%	T	14	4	22.22%	K	Somatic	1.0	0.1494505494505497	6	8	1	3	8	2	0	0
10	135524683	T	G	8	0	0%	T	12	6	33.33%	K	Somatic	1.0	0.0806324110671934	4	8	1	5	6	2	0	0
12	74424	A	G	11	0	0%	A	9	4	30.77%	R	Somatic	1.0	0.0672877846790886	3	6	1	3	6	5	0	0
19	5787214	T	C	8	0	0%	T	104	48	31.58%	Y	Somatic	1.0	0.0533237382017314	14	90	45	3	4	4	0	0
19	5787215	G	A	8	0	0%	G	108	43	28.48%	R	Somatic	1.0	0.0749951898968414	16	92	42	1	4	4	0	0
19	5787225	G	C	9	0	0%	G	77	68	46.9%	S	Somatic	1.0	0.0043465350626433	60	17	9	59	4	5	0	0
GL000220.1	111157	A	G	8	1	11.11%	A	193	173	47.27%	R	Somatic	1.0	0.0305701995502017	85	108	67	106	5	3	0	1
GL000220.1	119256	C	T	8	0	0%	C	520	460	46.94%	Y	Somatic	1.0	0.0064895477652285	248	272	195	265	2	6	0	0
GL000220.1	119385	T	C	10	0	0%	T	84	39	31.71%	Y	Somatic	1.0	0.0267945196208652	42	42	5	34	6	4	0	0
GL000220.1	122125	A	C	20	0	0%	A	85	53	38.41%	M	Somatic	1.0	0.00014328811996334743	16	69	21	32	5	15	0	0
GL000220.1	133051	T	G	42	9	17.65%	T	390	340	46.58%	K	Somatic	1.0	2.7057692115777063e-05	221	169	178	162	16	26	5	4
GL000220.1	133113	C	T	37	8	17.78%	C	456	203	30.8%	Y	Somatic	1.0	0.0423669499860207	242	214	50	153	23	14	5	3
GL000220.1	133129	C	T	41	10	19.61%	C	449	215	32.38%	Y	Somatic	1.0	0.0375713087737495	260	189	67	148	23	18	2	8
hs37d5	6743781	T	G	10	0	0%	T	80	20	20%	K	Somatic	1.0	0.121981530279867	20	60	7	13	5	5	0	0
hs37d5	6743799	T	G	14	0	0%	T	79	21	21%	K	Somatic	1.0	0.0474429773857678	26	53	5	16	5	9	0	0
hs37d5	8176320	C	T	13	2	13.33%	C	3	5	62.5%	Y	Somatic	1.0	0.0257304502828802	3	0	4	1	9	4	1	1
hs37d5	8264231	A	G	11	1	8.33%	A	20	14	41.18%	R	Somatic	1.0	0.0362678707008046	8	12	3	11	5	6	0	1
hs37d5	10290568	T	G	9	0	0%	T	8	2	20%	K	Somatic	1.0	0.2631578947368443	5	3	0	2	7	2	0	0
hs37d5	12101705	G	T	9	0	0%	G	6	2	25%	K	Somatic	1.0	0.2058823529411773	2	4	0	2	3	6	0	0
hs37d5	12105665	C	A	13	0	0%	C	7	2	22.22%	M	Somatic	1.0	0.1558441558441554	4	3	2	0	6	7	0	0
hs37d5	12105684	G	A	13	0	0%	G	8	3	27.27%	R	Somatic	1.0	0.0815217391304337	7	1	2	1	7	6	0	0
hs37d5	12106837	C	A	10	0	0%	C	9	5	35.71%	M	Somatic	1.0	0.0471014492753622	3	6	2	3	3	7	0	0
hs37d5	12113985	C	G	10	0	0%	C	8	2	20%	S	Somatic	1.0	0.2368421052631576	4	4	0	2	6	4	0	0
hs37d5	12249369	T	G	11	0	0%	T	12	3	20%	K	Somatic	1.0	0.1750000000000026	8	4	3	0	5	6	0	0
hs37d5	12992329	A	G	8	1	11.11%	A	56	98	63.64%	R	Somatic	1.0	0.0026051905872591	28	28	58	40	8	0	1	0
hs37d5	12995214	A	G	9	0	0%	A	54	115	68.05%	R	Somatic	1.0	5.880389405544563e-05	29	25	69	46	9	0	0	0
hs37d5	16046245	T	G	112	3	2.61%	T	792	347	30.47%	K	Somatic	1.0	1.1469032329907765e-13	499	293	284	63	70	42	3	0
hs37d5	16048161	A	G	12	0	0%	A	421	107	20.27%	R	Somatic	1.0	0.0685172131148042	293	128	81	26	6	6	0	0
hs37d5	16655936	T	A	24	0	0%	T	14	4	22.22%	W	Somatic	1.0	0.0273385151433941	3	11	1	3	5	19	0	0
hs37d5	16656217	G	A	33	1	2.94%	G	39	15	27.78%	R	Somatic	1.0	0.0021781817073621	38	1	15	0	30	3	1	0
hs37d5	16671047	A	T	8	0	0%	A	8	2	20%	W	Somatic	1.0	0.2941176470588277	6	2	1	1	8	0	0	0
hs37d5	16732797	G	C	7	1	12.5%	G	2	7	77.78%	C	Somatic	1.0	0.0122171945701356	2	0	6	1	6	1	1	0
hs37d5	17661095	C	A	30	1	3.23%	C	10	4	28.57%	M	Somatic	1.0	0.0270372471166564	5	5	4	0	19	11	1	0
hs37d5	17661106	C	T	30	1	3.23%	C	9	4	30.77%	Y	Somatic	1.0	0.0215946843853825	5	4	4	0	19	11	1	0
hs37d5	17664699	G	A	11	0	0%	G	8	3	27.27%	R	Somatic	1.0	0.1071428571428555	8	0	1	2	5	6	0	0
hs37d5	18886932	G	A	28	1	3.45%	G	59	18	23.38%	R	Somatic	1.0	0.0117422669839425	18	41	17	1	16	12	1	0
hs37d5	19352598	G	T	37	1	2.63%	G	22	8	26.67%	K	Somatic	1.0	0.0048035305842957	4	18	2	6	2	35	0	1
hs37d5	19352620	C	T	27	2	6.9%	C	15	6	28.57%	Y	Somatic	1.0	0.0476956831865068	2	13	2	4	0	27	0	2
hs37d5	19353279	G	T	59	8	11.94%	G	34	13	27.66%	K	Somatic	1.0	0.0303574280249716	9	25	1	12	6	53	0	8
hs37d5	19368260	C	T	57	4	6.56%	C	36	13	26.53%	Y	Somatic	1.0	0.0042598043501317	15	21	12	1	25	32	2	2
hs37d5	19514409	G	C	13	0	0%	G	12	3	20%	S	Somatic	1.0	0.1388888888888894	7	5	2	1	12	1	0	0
hs37d5	19563682	A	G	52	7	11.86%	A	9	5	35.71%	R	Somatic	1.0	0.0455196262435636	7	2	2	3	49	3	7	0
hs37d5	19690623	T	A	21	4	16%	T	7	25	78.12%	A	Somatic	1.0	2.9749054015723026e-06	2	5	3	22	1	20	0	4
hs37d5	19812331	A	T	17	0	0%	A	8	2	20%	W	Somatic	1.0	0.128205128205128	5	3	2	0	10	7	0	0
hs37d5	19813581	A	G	35	2	5.41%	A	10	4	28.57%	R	Somatic	1.0	0.0412973515030433	2	8	0	4	7	28	0	2
hs37d5	19813813	G	T	9	0	0%	G	7	2	22.22%	K	Somatic	1.0	0.235294117647059	5	2	1	1	6	3	0	0
hs37d5	20821417	T	A	11	0	0%	T	11	3	21.43%	W	Somatic	1.0	0.1582608695652178	5	6	2	1	10	1	0	0
hs37d5	20821563	G	A	9	0	0%	G	7	2	22.22%	R	Somatic	1.0	0.235294117647059	1	6	0	2	0	9	0	0
hs37d5	20822632	T	G	18	3	14.29%	T	9	12	57.14%	K	Somatic	1.0	0.0044202413433809	0	9	0	12	1	17	0	3
hs37d5	20824488	G	T	9	0	0%	G	8	3	27.27%	K	Somatic	1.0	0.1447368421052647	3	5	0	3	6	3	0	0
hs37d5	20825031	A	G	50	4	7.41%	A	22	7	24.14%	R	Somatic	1.0	0.0381312304428907	5	17	2	5	5	45	0	4
hs37d5	20825128	T	G	8	1	11.11%	T	4	8	66.67%	K	Somatic	1.0	0.0159051474840948	3	1	1	7	6	2	0	1
hs37d5	20825131	T	C	10	0	0%	T	9	3	25%	Y	Somatic	1.0	0.1428571428571415	4	5	0	3	7	3	0	0
hs37d5	21100052	T	C	62	7	10.14%	T	25	14	35.9%	Y	Somatic	1.0	0.0016063820134567	25	0	14	0	62	0	7	0
hs37d5	21111295	T	A	65	10	13.33%	T	106	93	46.73%	W	Somatic	1.0	9.895512379802044e-08	98	8	82	11	39	26	7	3
hs37d5	21112538	A	T	127	14	9.93%	A	86	23	21.1%	W	Somatic	1.0	0.0112960057199064	4	82	0	23	1	126	0	14
hs37d5	21117110	C	G	79	1	1.25%	C	9	10	52.63%	S	Somatic	1.0	5.922880474242952e-08	1	8	0	10	46	33	0	1
hs37d5	22480235	T	A	8	0	0%	T	7	2	22.22%	W	Somatic	1.0	0.2647058823529424	3	4	2	0	3	5	0	0
hs37d5	22541541	G	T	8	0	0%	G	4	10	71.43%	K	Somatic	1.0	0.001547987616099	4	0	10	0	8	0	0	0
hs37d5	22551981	A	G	9	0	0%	A	7	4	36.36%	R	Somatic	1.0	0.0681114551083591	6	1	3	1	7	2	0	0
hs37d5	22552052	C	G	9	0	0%	C	12	3	20%	S	Somatic	1.0	0.224802371541498	5	7	2	1	5	4	0	0
hs37d5	22552401	A	G	11	0	0%	A	8	2	20%	R	Somatic	1.0	0.2142857142857145	2	6	1	1	3	8	0	0
hs37d5	22569979	T	G	35	5	12.5%	T	41	22	34.92%	K	Somatic	1.0	0.0093375125812743	36	5	22	0	29	6	5	0
hs37d5	22570444	T	A	10	0	0%	T	8	2	20%	W	Somatic	1.0	0.2368421052631576	6	2	2	0	8	2	0	0
hs37d5	22840843	A	C	34	2	5.56%	A	9	4	30.77%	M	Somatic	1.0	0.0356482093299844	1	8	0	4	1	33	0	2
hs37d5	22842177	C	A	198	26	11.61%	C	99	27	21.43%	M	Somatic	1.0	0.0114668752992941	5	94	2	25	4	194	0	26
hs37d5	23654485	C	A	14	0	0%	C	16	4	20%	M	Somatic	1.0	0.1044721407624639	9	7	3	1	13	1	0	0
hs37d5	23654699	C	A	27	0	0%	C	9	3	25%	M	Somatic	1.0	0.0240726556516026	5	4	0	3	13	14	0	0
hs37d5	24127219	C	G	46	6	11.54%	C	28	11	28.21%	S	Somatic	1.0	0.0407742105465001	5	23	1	10	13	33	1	5
hs37d5	24127515	A	T	37	0	0%	A	18	5	21.74%	W	Somatic	1.0	0.0061611143580754	11	7	4	1	20	17	0	0
hs37d5	24129088	C	G	8	0	0%	C	8	2	20%	S	Somatic	1.0	0.2941176470588277	2	6	2	0	1	7	0	0
hs37d5	24684442	A	T	186	46	19.83%	A	176	64	26.67%	W	Somatic	1.0	0.0494758094384342	113	63	37	27	181	5	42	4
hs37d5	24685309	C	G	20	1	4.76%	C	24	9	27.27%	S	Somatic	1.0	0.0377117946125963	18	6	7	2	12	8	0	1
hs37d5	24686124	C	T	28	1	3.45%	C	15	5	25%	Y	Somatic	1.0	0.0349243725746964	5	10	1	4	6	22	0	1
hs37d5	24686180	T	G	22	0	0%	T	12	3	20%	K	Somatic	1.0	0.058558558558558	3	9	0	3	3	19	0	0
hs37d5	24793379	T	C	30	2	6.25%	T	224	72	24.32%	Y	Somatic	1.0	0.0113424010952517	206	18	67	5	24	6	0	2
hs37d5	25471325	G	T	142	18	11.25%	G	111	36	24.49%	K	Somatic	1.0	0.0018269536818288	33	78	6	30	16	126	2	16
hs37d5	25471347	C	T	138	22	13.75%	C	106	34	24.29%	Y	Somatic	1.0	0.0143216706885636	12	94	0	34	14	124	3	19
hs37d5	25472604	T	C	27	1	3.57%	T	7	3	30%	Y	Somatic	1.0	0.0483641536273128	1	6	0	3	5	22	0	1
hs37d5	25472605	C	G	28	0	0%	C	8	2	20%	S	Somatic	1.0	0.0640113798008536	1	7	0	2	5	23	0	0
hs37d5	25472626	C	A	22	0	0%	C	8	2	20%	M	Somatic	1.0	0.0907258064516143	1	7	0	2	3	19	0	0
hs37d5	26025636	T	C	25	1	3.85%	T	10	4	28.57%	Y	Somatic	1.0	0.0425952268057526	9	1	4	0	24	1	1	0
hs37d5	26026165	T	C	8	0	0%	T	158	46	22.55%	Y	Somatic	1.0	0.1360952047586773	144	14	44	2	8	0	0	0
hs37d5	26163048	A	G	9	0	0%	A	6	2	25%	R	Somatic	1.0	0.2058823529411773	4	2	1	1	8	1	0	0
hs37d5	26163187	G	T	14	0	0%	G	6	2	25%	K	Somatic	1.0	0.1212121212121225	6	0	2	0	12	2	0	0
hs37d5	26170266	T	C	20	0	0%	T	9	3	25%	Y	Somatic	1.0	0.0443548387096774	7	2	1	2	18	2	0	0
hs37d5	26170297	G	T	30	1	3.23%	G	11	4	26.67%	K	Somatic	1.0	0.0330606367006771	5	6	3	1	25	5	1	0
hs37d5	26170721	G	A	10	0	0%	G	7	3	30%	R	Somatic	1.0	0.1052631578947376	2	5	2	1	7	3	0	0
hs37d5	26171032	T	G	129	26	16.77%	T	121	75	38.27%	K	Somatic	1.0	6.143977490230511e-06	93	28	70	5	67	62	18	8
hs37d5	26171148	T	A	102	16	13.56%	T	107	39	26.71%	W	Somatic	1.0	0.0063206040729211	5	102	0	39	5	97	0	16
hs37d5	26171150	A	T	101	16	13.68%	A	99	42	29.79%	W	Somatic	1.0	0.0014469687128075	5	94	0	42	4	97	0	16
hs37d5	26299000	G	T	10	0	0%	G	10	3	23.08%	K	Somatic	1.0	0.1614906832298124	5	5	2	1	7	3	0	0
hs37d5	26299068	A	C	14	0	0%	A	8	3	27.27%	M	Somatic	1.0	0.0717391304347831	5	3	1	2	7	7	0	0
hs37d5	26299670	A	C	12	3	20%	M	4	8	66.67%	M	Somatic	1.0	0.0191232557096063	3	1	6	2	9	3	3	0
hs37d5	26299788	C	T	26	2	7.14%	C	8	6	42.86%	Y	Somatic	1.0	0.0104569267598793	5	3	0	6	15	11	1	1
hs37d5	26878834	A	G	453	90	16.57%	A	126	70	35.71%	R	Somatic	1.0	5.908335423974644e-08	16	110	49	21	58	395	37	53
hs37d5	26881380	A	C	33	7	17.5%	A	54	41	43.16%	M	Somatic	1.0	0.0032283056523994	12	42	9	32	16	17	4	3
hs37d5	27055919	G	C	16	0	0%	G	21	6	22.22%	S	Somatic	1.0	0.0485544547699372	14	7	1	5	4	12	0	0
hs37d5	27431876	T	G	8	0	0%	T	92	49	34.75%	K	Somatic	1.0	0.0373908720843204	24	68	7	42	2	6	0	0
hs37d5	27815232	C	T	189	39	17.11%	C	167	54	24.43%	Y	Somatic	1.0	0.0358562967348617	162	5	53	1	180	9	38	1
hs37d5	27815254	A	G	210	40	16%	A	222	63	22.11%	R	Somatic	1.0	0.0463403279111818	208	14	55	8	190	20	37	3
hs37d5	27815437	G	C	8	0	0%	G	6	2	25%	S	Somatic	1.0	0.2333333333333349	2	4	1	1	2	6	0	0
hs37d5	27816334	G	T	75	4	5.06%	G	75	23	23.47%	K	Somatic	1.0	0.0004647206114460026	9	66	2	21	5	70	1	3
hs37d5	27816356	C	T	60	3	4.76%	C	60	15	20%	Y	Somatic	1.0	0.006760981995518	5	55	0	15	3	57	0	3
hs37d5	27903489	A	T	31	1	3.12%	A	47	18	27.69%	W	Somatic	1.0	0.0024590777655711	19	28	18	0	1	30	0	1
hs37d5	27903491	G	A	28	0	0%	G	40	24	37.5%	R	Somatic	1.0	3.100735521068421e-05	16	24	21	3	1	27	0	0
hs37d5	27904370	C	T	25	3	10.71%	C	30	15	33.33%	Y	Somatic	1.0	0.0255822736891609	14	16	0	15	7	18	0	3
hs37d5	27904702	G	C	13	2	13.33%	G	51	51	50%	S	Somatic	1.0	0.006586768672039	36	15	3	48	13	0	2	0
hs37d5	28249624	G	T	11	0	0%	G	8	3	27.27%	K	Somatic	1.0	0.1071428571428555	2	6	0	3	3	8	0	0
hs37d5	28249964	G	T	46	1	2.13%	G	15	5	25%	K	Somatic	1.0	0.0076901913685733	13	2	4	1	44	2	1	0
hs37d5	28251515	A	C	10	0	0%	A	5	3	37.5%	M	Somatic	1.0	0.0686274509803926	4	1	3	0	9	1	0	0
hs37d5	28328254	C	T	44	2	4.35%	C	92	27	22.69%	Y	Somatic	1.0	0.002937340601105	62	30	25	2	34	10	0	2
hs37d5	28348715	T	G	69	10	12.66%	T	26	10	27.78%	K	Somatic	1.0	0.0455709411905539	16	10	6	4	34	35	9	1
hs37d5	28349973	T	C	54	1	1.82%	T	16	4	20%	Y	Somatic	1.0	0.0163377152958477	16	0	4	0	54	0	1	0
hs37d5	28349988	T	C	263	23	8.04%	T	73	21	22.34%	Y	Somatic	1.0	0.0003530921864064041	71	2	21	0	256	7	23	0
hs37d5	28350886	C	G	48	4	7.69%	C	16	7	30.43%	S	Somatic	1.0	0.0159956795484533	9	7	1	6	5	43	0	4
hs37d5	28350944	A	G	10	0	0%	A	9	3	25%	R	Somatic	1.0	0.1428571428571415	5	4	3	0	7	3	0	0
hs37d5	28860019	A	T	11	0	0%	A	7	3	30%	W	Somatic	1.0	0.0902255639097742	4	3	2	1	8	3	0	0
hs37d5	28860023	G	A	14	0	0%	G	7	2	22.22%	R	Somatic	1.0	0.1422924901185766	5	2	1	1	9	5	0	0
hs37d5	29284540	C	A	68	14	17.07%	C	27	14	34.15%	M	Somatic	1.0	0.0303263134951199	24	3	11	3	64	4	14	0
hs37d5	29286174	T	G	53	8	13.11%	T	9	8	47.06%	K	Somatic	1.0	0.0048463829902934	4	5	0	8	42	11	2	6
hs37d5	29336992	A	T	8	0	0%	A	49	15	23.44%	W	Somatic	1.0	0.138057416530329	6	43	1	14	3	5	0	0
hs37d5	29338064	C	T	19	2	9.52%	C	4	29	87.88%	T	Somatic	1.0	8.01921314913933e-09	1	3	2	27	18	1	1	1
hs37d5	29338092	G	T	31	0	0%	G	11	7	38.89%	K	Somatic	1.0	0.0003704747804741303	5	6	0	7	30	1	0	0
hs37d5	29431464	C	T	8	0	0%	C	7	2	22.22%	Y	Somatic	1.0	0.2647058823529424	4	3	1	1	5	3	0	0
hs37d5	29432437	T	C	9	0	0%	T	8	2	20%	Y	Somatic	1.0	0.2631578947368443	5	3	2	0	4	5	0	0
hs37d5	29432466	C	A	10	0	0%	C	8	2	20%	M	Somatic	1.0	0.2368421052631576	6	2	2	0	6	4	0	0
hs37d5	29850910	C	G	9	0	0%	C	8	2	20%	S	Somatic	1.0	0.2631578947368443	6	2	2	0	7	2	0	0
hs37d5	29852060	T	C	21	2	8.7%	T	27	27	50%	Y	Somatic	1.0	0.0004063131777943152	15	12	27	0	13	8	2	0
hs37d5	29852790	G	A	15	3	16.67%	G	20	19	48.72%	R	Somatic	1.0	0.0194764518281538	12	8	8	11	5	10	1	2
hs37d5	29865665	T	C	17	1	5.56%	T	14	8	36.36%	Y	Somatic	1.0	0.0228690228690221	7	7	7	1	1	16	1	0
hs37d5	29865686	G	C	16	1	5.88%	G	15	13	46.43%	S	Somatic	1.0	0.0040548205607763	5	10	11	2	2	14	1	0
hs37d5	29867155	G	T	61	4	6.15%	G	34	12	26.09%	K	Somatic	1.0	0.0038400185853624	27	7	11	1	49	12	4	0
hs37d5	29890092	G	A	8	0	0%	G	8	2	20%	R	Somatic	1.0	0.2941176470588277	3	5	2	0	5	3	0	0
hs37d5	29890180	A	C	9	1	10%	A	6	7	53.85%	M	Somatic	1.0	0.0376228294521472	1	5	4	3	3	6	0	1
hs37d5	29890196	A	G	9	1	10%	A	5	7	58.33%	R	Somatic	1.0	0.0263157894736844	1	4	4	3	3	6	0	1
hs37d5	29935889	C	T	10	0	0%	C	7	4	36.36%	Y	Somatic	1.0	0.0551378446115293	3	4	3	1	2	8	0	0
hs37d5	29977771	G	C	34	8	19.05%	G	178	139	43.85%	S	Somatic	1.0	0.0013072015862212	56	122	57	82	17	17	2	6
hs37d5	29980447	G	C	8	0	0%	G	2	5	71.43%	S	Somatic	1.0	0.0069930069930069	1	1	3	2	8	0	0	0
hs37d5	29980699	T	A	32	6	15.79%	T	56	37	39.78%	W	Somatic	1.0	0.0057543691524508	5	51	23	14	4	28	5	1
hs37d5	30001212	G	A	24	0	0%	G	6	2	25%	R	Somatic	1.0	0.0564516129032251	6	0	1	1	24	0	0	0
hs37d5	30001242	A	C	29	1	3.33%	A	6	3	33.33%	M	Somatic	1.0	0.0321698216435058	5	1	3	0	29	0	1	0
hs37d5	30001324	T	C	85	5	5.56%	T	23	6	20.69%	Y	Somatic	1.0	0.0241026252673767	20	3	6	0	72	13	5	0
hs37d5	30001349	A	G	219	32	12.75%	A	73	20	21.51%	R	Somatic	1.0	0.0351614395951598	68	5	20	0	185	34	30	2
hs37d5	30001392	C	T	254	40	13.61%	C	171	50	22.62%	Y	Somatic	1.0	0.0055484710786948	161	10	50	0	215	39	33	7
hs37d5	30002667	C	T	11	0	0%	C	7	2	22.22%	Y	Somatic	1.0	0.1894736842105263	5	2	1	1	8	3	0	0
1	725462	C	-GATGGGATGG	32	0	0%	C	7	3	30%	*/-GATGGGATGG	Somatic	1.0	0.0104529616724741	3	4	1	2	15	17	0	0
1	1413817	T	-TC	43	1	2.27%	T	14	5	26.32%	*/-TC	Somatic	1.0	0.0079293526941972	6	8	5	0	21	22	1	0
1	1583276	T	-C	55	12	17.91%	T	86	37	30.08%	*/-C	Somatic	1.0	0.046717657569496	64	22	36	1	41	14	10	2
1	3418612	C	-CCGG	19	0	0%	C	56	19	25.33%	*/-CCGG	Somatic	1.0	0.00796120666993	28	28	12	7	5	14	0	0
1	5770814	A	-GGGAAGGAG	48	2	4%	A	15	5	25%	*/-GGGAAGGAG	Somatic	1.0	0.0175244936763437	2	13	0	5	10	38	0	2
1	8716321	C	-TCTTTG	198	40	16.81%	C	268	128	32.32%	*/-TCTTTG	Somatic	1.0	9.228021914355805e-06	81	187	31	97	64	134	17	23
1	9096899	T	-A	108	17	13.6%	T	66	21	24.14%	*/-A	Somatic	1.0	0.0378208456258135	64	2	21	0	102	6	17	0
1	10518591	A	+T	77	0	0%	A	55	17	23.61%	*/+T	Somatic	1.0	1.415961355897032e-06	11	44	2	15	47	30	0	0
1	11140621	A	-CACAC	40	2	4.76%	A	11	4	26.67%	*/-CACAC	Somatic	1.0	0.0360005216013162	2	9	1	3	14	26	0	2
1	14762853	C	-TGG	9	0	0%	C	5	3	37.5%	*/-TGG	Somatic	1.0	0.0823529411764703	3	2	2	1	3	6	0	0
1	16971096	T	+AGCC	9	0	0%	T	9	3	25%	*/+AGCC	Somatic	1.0	0.1654135338345876	5	4	2	1	4	5	0	0
1	17054245	G	-C	12	0	0%	G	6	4	40%	*/-C	Somatic	1.0	0.0287081339712921	4	2	1	3	12	0	0	0
1	17231625	T	-C	8	0	0%	T	4	5	55.56%	*/-C	Somatic	1.0	0.0203619909502262	3	1	3	2	5	3	0	0
1	17257187	G	+TCCGAGGGAGC	12	0	0%	G	4	2	33.33%	*/+TCCGAGGGAGC	Somatic	1.0	0.0980392156862754	1	3	0	2	5	7	0	0
1	19223386	C	-A	12	0	0%	C	7	2	22.22%	*/-A	Somatic	1.0	0.1714285714285741	7	0	2	0	12	0	0	0
1	22082967	C	-A	90	21	18.92%	C	41	35	46.05%	*/-A	Somatic	1.0	7.133177510172125e-05	41	0	35	0	89	1	19	2
1	23107811	T	-A	46	3	6.12%	T	32	11	25.58%	*/-A	Somatic	1.0	0.0099913467626872	32	0	11	0	46	0	3	0
1	25780929	A	-TGTG	10	0	0%	A	7	3	30%	*/-TGTG	Somatic	1.0	0.1052631578947376	1	6	0	3	0	10	0	0
1	26139055	A	-ACACACAC	41	9	18%	A	24	21	46.67%	*/-ACACACAC	Somatic	1.0	0.0025717424212795	24	0	16	5	40	1	8	1
1	26514111	C	-TTT	4	0	0%	C	7	2	22.22%	*/-TTT	Somatic	1.0	0.4615384615384648	0	7	0	2	0	4	0	0
1	28087395	T	+C	42	2	4.55%	T	15	6	28.57%	*/+C	Somatic	1.0	0.0112243454009848	4	11	4	2	17	25	2	0
1	28087457	G	-T	43	6	12.24%	G	80	34	29.82%	*/-T	Somatic	1.0	0.0116819247125303	79	1	33	1	41	2	5	1
1	39900058	C	-T	7	0	0%	C	9	3	25%	*/-T	Somatic	1.0	0.2270381836945303	9	0	3	0	7	0	0	0
1	43054894	C	-A	7	0	0%	C	13	5	27.78%	*/-A	Somatic	1.0	0.1612648221343872	13	0	5	0	7	0	0	0
1	45206451	G	-T	27	3	10%	G	20	11	35.48%	*/-T	Somatic	1.0	0.0182833985734351	20	0	11	0	26	1	3	0
1	45223901	T	-ATTAGCTG	12	2	14.29%	T	6	8	57.14%	*/-ATTAGCTG	Somatic	1.0	0.0230358504958046	0	6	2	6	0	12	0	2
1	45804423	T	+G	8	0	0%	T	7	2	22.22%	*/+G	Somatic	1.0	0.2647058823529424	0	7	0	2	1	7	0	0
1	52377062	T	-TTTG	70	13	15.66%	T	97	62	38.99%	*/-TTTG	Somatic	1.0	0.0001110334105176168	25	72	10	52	12	58	5	8
1	52380920	A	-T	41	10	19.61%	A	185	152	45.1%	*/-T	Somatic	1.0	0.0003311905678084663	75	110	65	87	17	24	1	9
1	52446101	C	-A	10	0	0%	C	10	3	23.08%	*/-A	Somatic	1.0	0.1614906832298124	8	2	3	0	10	0	0	0
1	59096306	T	-AC	121	14	10.37%	T	264	68	20.48%	*/-AC	Somatic	1.0	0.005354935685088	83	181	2	66	67	54	1	13
1	62121189	A	+T	18	2	10%	A	15	14	48.28%	*/+T	Somatic	1.0	0.0048849077342579	3	12	2	12	1	17	2	0
1	66618264	C	-AT	25	5	16.67%	C	31	30	49.18%	*/-AT	Somatic	1.0	0.0022015933560389	1	30	1	29	2	23	0	5
1	67356549	G	+GAAGAA	11	0	0%	G	7	7	50%	*/+GAAGAA	Somatic	1.0	0.0071395881006864	3	4	4	3	3	8	0	0
1	72739678	C	-T	12	0	0%	C	27	7	20.59%	*/-T	Somatic	1.0	0.1005072052742802	27	0	7	0	12	0	0	0
1	83460220	A	-TG	9	0	0%	A	6	6	50%	*/-TG	Somatic	1.0	0.0170278637770899	4	2	1	5	2	7	0	0
1	85725353	G	-CCGGAAA	29	7	19.44%	G	23	16	41.03%	*/-CCGGAAA	Somatic	1.0	0.037173248837789	1	22	0	16	6	23	0	7
1	86372839	T	+G	18	4	18.18%	T	126	99	44%	*/+G	Somatic	1.0	0.0144225484228174	105	21	77	22	17	1	3	1
1	92496014	C	+GTGTGTGTGT	40	0	0%	C	7	2	22.22%	*/+GTGTGTGTGT	Somatic	1.0	0.0306122448979585	1	6	1	1	1	39	0	0
1	93397121	G	-A	5	1	16.67%	G	6	12	66.67%	*/-A	Somatic	1.0	0.0480549199084661	5	1	9	3	5	0	1	0
1	113238667	A	+G	23	0	0%	A	8	2	20%	*/+G	Somatic	1.0	0.0852272727272713	7	1	2	0	20	3	0	0
1	113255686	T	+TG	65	7	9.72%	T	35	12	25.53%	*/+TG	Somatic	1.0	0.021302181173631	7	28	1	11	4	61	1	6
1	114241242	T	-AC	8	0	0%	T	8	3	27.27%	*/-AC	Somatic	1.0	0.1702786377708978	2	6	0	3	1	7	0	0
1	115126456	A	+AC	19	2	9.52%	A	18	10	35.71%	*/+AC	Somatic	1.0	0.0350867287212492	17	1	9	1	16	3	2	0
1	118166786	C	-T	104	12	10.34%	C	280	82	22.65%	*/-T	Somatic	1.0	0.0018976989944313	180	100	54	28	68	36	6	6
1	118483374	A	+C	16	0	0%	A	11	5	31.25%	*/+C	Somatic	1.0	0.0216907675194663	11	0	5	0	16	0	0	0
1	118502732	C	-GTGTGT	150	11	6.83%	C	123	46	27.22%	*/-GTGTGT	Somatic	1.0	5.021778396318669e-07	42	81	22	24	49	101	6	5
1	118502769	G	-TA	81	12	12.9%	G	61	27	30.68%	*/-TA	Somatic	1.0	0.0030259889177625	35	26	12	15	51	30	6	6
1	142537569	A	-ATGTG	21	0	0%	A	14	5	26.32%	*/-ATGTG	Somatic	1.0	0.0176715176715177	5	9	2	3	14	7	0	0
1	142538778	A	+T	25	2	7.41%	A	10	8	44.44%	*/+T	Somatic	1.0	0.0052396785835599	5	5	6	2	12	13	1	1
1	142538835	G	-C	18	0	0%	G	11	3	21.43%	*/-C	Somatic	1.0	0.0733870967741949	8	3	2	1	9	9	0	0
1	143283410	A	-ACACACACC	25	0	0%	A	9	10	52.63%	*/-ACACACACC	Somatic	1.0	3.723032650996266e-05	0	9	0	10	5	20	0	0
1	144536014	T	+A	10	0	0%	T	8	2	20%	*/+A	Somatic	1.0	0.2368421052631576	2	6	0	2	8	2	0	0
1	145236834	C	-T	17	0	0%	C	8	2	20%	*/-T	Somatic	1.0	0.128205128205128	3	5	0	2	10	7	0	0
1	150201619	T	-A	8	0	0%	T	6	2	25%	*/-A	Somatic	1.0	0.2333333333333349	0	6	0	2	1	7	0	0
1	150914922	C	-A	52	11	17.46%	C	36	23	38.98%	*/-A	Somatic	1.0	0.0069572045703705	35	1	21	2	49	3	11	0
1	151789607	T	-GCGC	25	1	3.85%	T	6	23	79.31%	-GCGC/-GCGC	Somatic	1.0	5.010579195893933e-09	6	0	19	4	24	1	0	1
1	156845492	A	+GT	80	2	2.44%	A	30	8	21.05%	*/+GT	Somatic	1.0	0.0015184884197806	6	24	1	7	7	73	0	2
1	158815342	T	-TTTAAG	9	2	18.18%	T	4	8	66.67%	*/-TTTAAG	Somatic	1.0	0.0259696555967923	4	0	7	1	4	5	2	0
1	161192845	C	-CACACA	156	26	14.29%	C	58	36	38.3%	*/-CACACA	Somatic	1.0	8.8993015250801e-06	20	38	8	28	32	124	2	24
1	174769068	G	-CACACACACACACACACACACACACA	102	6	5.56%	G	79	61	43.57%	*/-CACACACACACACACACACACACACA	Somatic	1.0	1.5628680062059757e-12	78	1	57	4	100	2	6	0
1	179317895	A	-TGTGTGTGTGTGTGTGTGTGTGTGTG	56	6	9.68%	A	57	23	28.75%	*/-TGTGTGTGTGTGTGTGTGTGTGTGTG	Somatic	1.0	0.0040138873689525	56	1	23	0	56	0	6	0
1	183218026	A	-GT	59	11	15.71%	A	59	33	35.87%	*/-GT	Somatic	1.0	0.003234162132724	33	26	25	8	35	24	9	2
1	197414036	T	+ACAC	45	9	16.67%	T	34	33	49.25%	*/+ACAC	Somatic	1.0	0.00014469024779541163	4	30	0	33	2	43	0	9
1	201837934	C	-GT	75	7	8.54%	C	38	14	26.92%	*/-GT	Somatic	1.0	0.0049302873875792	1	37	2	12	1	74	0	7
1	202565428	C	-ACACACAT	100	1	0.99%	C	24	42	63.64%	*/-ACACACAT	Somatic	1.0	3.8377834791996935e-21	18	6	25	17	66	34	1	0
1	204988603	C	+CATTCATT	66	15	18.52%	C	185	123	39.94%	*/+CATTCATT	Somatic	1.0	0.00017324015298915375	50	135	27	96	11	55	6	9
1	206635245	T	-AC	103	25	19.53%	T	55	60	52.17%	*/-AC	Somatic	1.0	7.9898687586528e-08	17	38	11	49	12	91	8	17
1	214656606	C	-TCTT	14	5	26.32%	C	42	47	52.81%	*/-TCTT	Somatic	1.0	0.0311504914669411	27	15	26	21	11	3	0	0
1	215409388	A	+ATCT	24	4	14.29%	A	50	27	35.06%	*/+ATCT	Somatic	1.0	0.0304425221333886	20	30	25	2	8	16	4	0
1	222924147	C	-A	21	5	19.23%	C	27	19	41.3%	*/-A	Somatic	1.0	0.0475391810852505	4	23	1	18	3	18	1	4
1	223367607	C	+AGAG	10	0	0%	C	8	6	42.86%	*/+AGAG	Somatic	1.0	0.0223112128146449	3	5	1	5	3	7	0	0
1	226438484	T	-CTCA	12	1	7.69%	T	55	39	41.49%	*/-CTCA	Somatic	1.0	0.0146432417160423	44	11	30	9	9	3	1	0
1	227148028	T	+G	14	0	0%	T	6	2	25%	*/+G	Somatic	1.0	0.1212121212121225	4	2	2	0	8	6	0	0
1	227148164	T	-TGG	11	0	0%	T	9	3	25%	*/-TGG	Somatic	1.0	0.1242236024844708	4	5	3	0	5	6	0	0
1	231337901	G	+AGA	23	0	0%	G	12	6	33.33%	*/+AGA	Somatic	1.0	0.0041286472608679	6	6	1	5	11	12	0	0
1	240370913	T	-GCCCCCTCTACCCGGAGCGGGAATACCTCCTCC	525	0	0%	T	192	87	31.18%	*/-GCCCCCTCTACCCGGAGCGGGAATACCTCCTCC	Somatic	1.0	3.6926483072060443e-45	70	122	40	47	277	248	0	0
1	241850606	T	-A	34	5	12.82%	T	47	19	28.79%	*/-A	Somatic	1.0	0.0474623382133554	47	0	19	0	34	0	5	0
1	247200173	T	-ACACACACACACAC	82	3	3.53%	T	104	82	44.09%	*/-ACACACACACACAC	Somatic	1.0	1.9371692381397315e-13	79	25	59	23	53	29	2	1
2	8822892	C	-A	5	0	0%	C	6	2	25%	*/-A	Somatic	1.0	0.3589743589743588	6	0	2	0	5	0	0	0
2	10452317	T	-CATCATCACTGTCATCATCAACATC	8	0	0%	T	8	2	20%	*/-CATCATCACTGTCATCATCAACATC	Somatic	1.0	0.2941176470588277	4	4	2	0	2	6	0	0
2	243152574	T	+A	17	0	0%	T	16	4	20%	*/+A	Somatic	1.0	0.0733590733590753	9	7	0	4	14	3	0	0
4	191044096	T	-G	23	0	0%	T	5	2	28.57%	*/-G	Somatic	1.0	0.0482758620689657	0	5	2	0	7	16	0	0
10	130262779	C	-A	8	0	0%	C	69	28	28.87%	*/-A	Somatic	1.0	0.0754686127513966	40	29	15	13	5	3	0	0
10	130262813	C	-A	9	0	0%	C	92	30	24.59%	*/-A	Somatic	1.0	0.0883353664955345	54	38	15	15	4	5	0	0
18	4510912	G	+GT	8	0	0%	G	17	7	29.17%	*/+GT	Somatic	1.0	0.1028279284675291	9	8	3	4	5	3	0	0
GL000220.1	102981	G	-CTTT	10	1	9.09%	G	78	59	43.07%	*/-CTTT	Somatic	1.0	0.0237039746727888	31	47	15	44	2	8	0	1
GL000220.1	116397	C	+CT	8	1	11.11%	C	158	127	44.56%	*/+CT	Somatic	1.0	0.0438859726817925	121	37	116	11	1	7	0	1
GL000220.1	119493	T	-TCTC	8	0	0%	T	78	41	34.45%	*/-TCTC	Somatic	1.0	0.0395870538821477	66	12	33	8	5	3	0	0
GL000220.1	128873	G	-TC	14	1	6.67%	G	228	104	31.33%	*/-TC	Somatic	1.0	0.0309970090688083	138	90	62	42	4	10	1	0
GL000220.1	129152	G	-TC	24	0	0%	G	299	86	22.34%	*/-TC	Somatic	1.0	0.0028701737608769	154	145	49	37	14	10	0	0
GL000220.1	129311	T	-CC	9	0	0%	T	176	50	22.12%	*/-CC	Somatic	1.0	0.111287344796456	84	92	29	21	7	2	0	0
GL000220.1	132644	G	-TCTC	40	2	4.76%	G	265	178	40.18%	*/-TCTC	Somatic	1.0	4.756304116119773e-07	132	133	99	79	14	26	0	2
GL000220.1	133098	G	+TCTC	69	8	10.39%	G	563	154	21.48%	*/+TCTC	Somatic	1.0	0.0119222526999795	282	281	53	101	42	27	5	3
GL000220.1	133569	G	-TC	13	1	7.14%	G	218	111	33.74%	*/-TC	Somatic	1.0	0.0283216607205102	102	116	67	44	7	6	1	0
GL000220.1	135693	C	-CT	25	0	0%	C	172	197	53.39%	*/-CT	Somatic	1.0	1.3224671166268829e-08	65	107	106	91	11	14	0	0
GL000220.1	136177	T	-TCTCTCTCTCTC	36	3	7.69%	T	181	133	42.36%	*/-TCTCTCTCTCTC	Somatic	1.0	5.758638416845102e-06	74	107	78	55	18	18	0	3
GL000220.1	136472	G	-GTGT	36	1	2.7%	G	607	176	22.48%	*/-GTGT	Somatic	1.0	0.0011578958604821	387	220	108	68	29	7	0	1
GL000220.1	136782	G	-TC	19	0	0%	G	181	139	43.44%	*/-TC	Somatic	1.0	3.0592195566476704e-05	101	80	77	62	11	8	0	0
GL000220.1	146663	C	+TTTTG	11	0	0%	C	71	63	47.01%	*/+TTTTG	Somatic	1.0	0.0013841209882891	28	43	37	26	3	8	0	0
GL000220.1	160369	C	+CT	13	2	13.33%	C	178	111	38.41%	*/+CT	Somatic	1.0	0.0400014830980016	148	30	93	18	5	8	0	2
hs37d5	16656191	G	-A	31	0	0%	G	29	10	25.64%	*/-A	Somatic	1.0	0.001602566538046	29	0	10	0	30	1	0	0
hs37d5	19368970	A	-C	16	2	11.11%	A	8	6	42.86%	*/-C	Somatic	1.0	0.0498405635891728	0	8	2	4	4	12	1	1
hs37d5	29935910	C	-T	10	0	0%	C	7	4	36.36%	*/-T	Somatic	1.0	0.0551378446115293	2	5	0	4	1	9	0	0
