chrom	position	ref	var	normal_reads1	normal_reads2	normal_var_freq	normal_gt	tumor_reads1	tumor_reads2	tumor_var_freq	tumor_gt	somatic_status	variant_p_value	somatic_p_value	tumor_reads1_plus	tumor_reads1_minus	tumor_reads2_plus	tumor_reads2_minus	normal_reads1_plus	normal_reads1_minus	normal_reads2_plus	normal_reads2_minus
1	131702	G	A	26	1	3.7%	G	36	14	28%	R	Somatic	1.0	0.0078155337922018	16	20	6	8	11	15	0	1
1	131736	C	T	23	2	8%	C	24	11	31.43%	Y	Somatic	1.0	0.0285483456001695	13	11	6	5	12	11	0	2
1	331648	C	T	29	4	12.12%	C	26	13	33.33%	Y	Somatic	1.0	0.0316558587933125	13	13	8	5	22	7	2	2
1	871310	G	A	38	0	0%	G	8	2	20%	R	Somatic	1.0	0.0398936170212756	3	5	1	1	0	38	0	0
1	1464663	G	A	104	14	11.86%	G	39	14	26.42%	R	Somatic	1.0	0.017557727165147	14	25	10	4	16	88	12	2
1	1599940	C	T	285	54	15.93%	C	194	75	27.88%	Y	Somatic	1.0	0.0002585931131969163	90	104	6	69	145	140	1	53
1	2607868	C	T	9	0	0%	C	7	3	30%	Y	Somatic	1.0	0.1238390092879262	4	3	3	0	4	5	0	0
1	3610981	C	T	15	0	0%	C	11	5	31.25%	Y	Somatic	1.0	0.0257075763193675	8	3	5	0	10	5	0	0
1	4204601	T	C	14	0	0%	T	7	2	22.22%	Y	Somatic	1.0	0.1422924901185766	3	4	1	1	10	4	0	0
1	4666819	A	G	7	1	12.5%	A	2	6	75%	G	Somatic	1.0	0.0202797202797201	1	1	3	3	4	3	1	0
1	12907496	T	C	12	0	0%	T	6	3	33.33%	Y	Somatic	1.0	0.0631578947368422	0	6	0	3	0	12	0	0
1	12907507	C	T	9	0	0%	C	6	2	25%	Y	Somatic	1.0	0.2058823529411773	0	6	0	2	0	9	0	0
1	12907742	G	A	8	0	0%	G	8	3	27.27%	R	Somatic	1.0	0.1702786377708978	8	0	3	0	8	0	0	0
1	13183492	T	C	12	0	0%	T	15	5	25%	Y	Somatic	1.0	0.0769903066899726	9	6	5	0	8	4	0	0
1	13632440	G	T	14	1	6.67%	G	6	9	60%	K	Somatic	1.0	0.0025987006496751	4	2	9	0	11	3	1	0
1	16927932	G	C	9	0	0%	G	8	3	27.27%	S	Somatic	1.0	0.1447368421052647	3	5	2	1	7	2	0	0
1	16946282	C	T	32	1	3.03%	C	17	5	22.73%	Y	Somatic	1.0	0.0325507271123253	11	6	4	1	26	6	1	0
1	16954029	C	G	11	0	0%	C	6	2	25%	S	Somatic	1.0	0.1637426900584798	1	5	1	1	4	7	0	0
1	16956911	C	A	11	0	0%	C	7	3	30%	M	Somatic	1.0	0.0902255639097742	5	2	0	3	7	4	0	0
1	16983958	C	G	11	0	0%	C	8	2	20%	S	Somatic	1.0	0.2142857142857145	2	6	1	1	5	6	0	0
1	16993582	C	T	8	0	0%	C	6	2	25%	Y	Somatic	1.0	0.2333333333333349	4	2	2	0	4	4	0	0
1	21091712	T	A	14	0	0%	T	6	3	33.33%	W	Somatic	1.0	0.0474308300395256	6	0	3	0	14	0	0	0
1	21091718	C	A	17	0	0%	C	8	2	20%	M	Somatic	1.0	0.128205128205128	8	0	2	0	17	0	0	0
1	25586488	T	C	139	30	17.75%	T	169	58	25.55%	Y	Somatic	1.0	0.0415412221738357	122	47	40	18	105	34	26	4
1	25656474	T	C	13	0	0%	T	8	2	20%	Y	Somatic	1.0	0.1778656126482181	7	1	2	0	11	2	0	0
1	33475639	G	A	151	19	11.18%	G	153	41	21.13%	R	Somatic	1.0	0.0074377142329901	49	104	30	11	36	115	15	4
1	33475650	T	C	136	19	12.26%	T	153	40	20.73%	Y	Somatic	1.0	0.0247563131300705	42	111	25	15	34	102	12	7
1	43213610	T	C	18	3	14.29%	T	12	9	42.86%	Y	Somatic	1.0	0.0427467199693797	1	11	0	9	1	17	0	3
1	47349050	T	C	28	2	6.67%	T	25	9	26.47%	Y	Somatic	1.0	0.0363587838727134	4	21	0	9	5	23	0	2
1	48709776	A	C	11	0	0%	A	8	2	20%	M	Somatic	1.0	0.2142857142857145	0	8	0	2	0	11	0	0
1	54582563	C	T	10	0	0%	C	8	2	20%	Y	Somatic	1.0	0.2368421052631576	6	2	0	2	6	4	0	0
1	55064910	A	G	10	2	16.67%	A	6	12	66.67%	R	Somatic	1.0	0.0091533180778031	6	0	12	0	10	0	2	0
1	121129695	A	G	9	0	0%	A	13	4	23.53%	R	Somatic	1.0	0.1591973244147152	3	10	0	4	2	7	0	0
1	121478614	T	C	20	1	4.76%	T	8	6	42.86%	Y	Somatic	1.0	0.009888438133874	5	3	5	1	19	1	0	1
1	121478754	A	G	16	0	0%	A	8	2	20%	R	Somatic	1.0	0.1384615384615365	4	4	0	2	5	11	0	0
1	142537998	G	A	15	0	0%	G	7	2	22.22%	R	Somatic	1.0	0.1304347826086963	2	5	1	1	10	5	0	0
1	142538004	A	G	16	0	0%	A	7	2	22.22%	R	Somatic	1.0	0.1200000000000007	2	5	1	1	11	5	0	0
1	142538644	T	G	8	0	0%	T	8	2	20%	K	Somatic	1.0	0.2941176470588277	4	4	2	0	7	1	0	0
1	142538650	A	G	8	0	0%	A	7	2	22.22%	R	Somatic	1.0	0.2647058823529424	3	4	2	0	7	1	0	0
1	142538678	T	G	9	0	0%	T	7	3	30%	K	Somatic	1.0	0.1238390092879262	6	1	3	0	6	3	0	0
1	142538709	A	G	11	2	15.38%	A	4	9	69.23%	R	Somatic	1.0	0.0077096513662673	4	0	7	2	5	6	1	1
1	142538743	A	G	16	0	0%	A	12	4	25%	R	Somatic	1.0	0.0506117908787539	7	5	2	2	7	9	0	0
1	142538752	C	T	17	0	0%	C	11	5	31.25%	Y	Somatic	1.0	0.0184042875922738	7	4	3	2	8	9	0	0
1	142538762	G	A	15	0	0%	G	11	4	26.67%	R	Somatic	1.0	0.0498084291187737	5	6	2	2	7	8	0	0
1	142538856	G	C	8	0	0%	G	6	2	25%	S	Somatic	1.0	0.2333333333333349	3	3	0	2	5	3	0	0
1	142802500	G	T	14	0	0%	G	6	2	25%	K	Somatic	1.0	0.1212121212121225	5	1	1	1	8	6	0	0
1	143156659	G	A	9	0	0%	G	7	3	30%	R	Somatic	1.0	0.1238390092879262	1	6	1	2	3	6	0	0
1	143184917	T	G	10	0	0%	T	8	2	20%	K	Somatic	1.0	0.2368421052631576	4	4	0	2	4	6	0	0
1	143420143	C	T	20	1	4.76%	C	18	7	28%	Y	Somatic	1.0	0.0428320025597395	17	1	7	0	13	7	1	0
1	143420158	G	T	23	1	4.17%	G	17	7	29.17%	K	Somatic	1.0	0.0239618155706543	16	1	7	0	15	8	1	0
1	144531120	G	A	12	0	0%	G	8	3	27.27%	R	Somatic	1.0	0.0931677018633539	5	3	2	1	7	5	0	0
1	145256771	C	T	10	0	0%	C	9	3	25%	Y	Somatic	1.0	0.1428571428571415	3	6	2	1	4	6	0	0
1	145318821	T	G	20	0	0%	T	8	2	20%	K	Somatic	1.0	0.1034482758620701	4	4	0	2	10	10	0	0
1	145356839	A	G	8	0	0%	A	8	3	27.27%	R	Somatic	1.0	0.1702786377708978	4	4	1	2	7	1	0	0
1	145365676	T	C	8	0	0%	T	7	2	22.22%	Y	Somatic	1.0	0.2647058823529424	3	4	2	0	4	4	0	0
1	146248787	A	T	21	2	8.7%	A	12	7	36.84%	W	Somatic	1.0	0.0326961107448915	8	4	7	0	15	6	2	0
1	146395530	G	T	14	0	0%	G	6	2	25%	K	Somatic	1.0	0.1212121212121225	1	5	1	1	4	10	0	0
1	146410146	G	A	38	2	5%	G	12	4	25%	R	Somatic	1.0	0.049350329039563	7	5	3	1	16	22	2	0
1	146475845	T	C	9	0	0%	T	8	2	20%	Y	Somatic	1.0	0.2631578947368443	2	6	1	1	5	4	0	0
1	146475850	A	C	8	0	0%	A	8	2	20%	M	Somatic	1.0	0.2941176470588277	0	8	1	1	5	3	0	0
1	146490330	C	T	10	0	0%	C	6	3	33.33%	Y	Somatic	1.0	0.0866873065015481	5	1	2	1	10	0	0	0
1	147554301	A	C	8	0	0%	A	11	3	21.43%	M	Somatic	1.0	0.2363636363636351	10	1	3	0	8	0	0	0
1	148023067	C	T	24	0	0%	C	13	6	31.58%	Y	Somatic	1.0	0.0044504559535756	1	12	0	6	4	20	0	0
1	148742050	A	T	8	0	0%	A	6	2	25%	W	Somatic	1.0	0.2333333333333349	0	6	0	2	5	3	0	0
1	148930711	T	C	8	0	0%	T	7	2	22.22%	Y	Somatic	1.0	0.2647058823529424	4	3	0	2	3	5	0	0
1	148933411	T	C	21	2	8.7%	T	18	10	35.71%	Y	Somatic	1.0	0.024216646507023	6	12	4	6	9	12	2	0
1	149665406	T	C	53	3	5.36%	T	46	15	24.59%	Y	Somatic	1.0	0.0034602793247439	10	36	1	14	16	37	0	3
1	152186141	C	T	103	14	11.97%	C	109	28	20.44%	Y	Somatic	1.0	0.0493296110090377	98	11	11	17	81	22	9	5
1	152800123	G	T	22	4	15.38%	G	7	17	70.83%	K	Somatic	1.0	8.225912052024149e-05	3	4	3	14	14	8	1	3
1	152800128	C	T	21	4	16%	C	6	17	73.91%	Y	Somatic	1.0	6.081647067554752e-05	3	3	3	14	13	8	1	3
1	155719801	A	G	16	2	11.11%	A	10	8	44.44%	R	Somatic	1.0	0.0299539170506905	0	10	1	7	0	16	0	2
1	155887393	T	G	14	0	0%	T	6	2	25%	K	Somatic	1.0	0.1212121212121225	1	5	0	2	2	12	0	0
1	160177108	G	A	8	0	0%	G	6	2	25%	R	Somatic	1.0	0.2333333333333349	2	4	1	1	4	4	0	0
1	161417269	C	T	8	0	0%	C	6	2	25%	Y	Somatic	1.0	0.2333333333333349	5	1	2	0	4	4	0	0
1	161438337	C	T	12	0	0%	C	8	2	20%	Y	Somatic	1.0	0.1948051948051969	2	6	2	0	3	9	0	0
1	161562049	G	A	25	3	10.71%	G	11	7	38.89%	R	Somatic	1.0	0.0299780571784166	0	11	0	7	3	22	2	1
1	180856092	G	A	17	0	0%	G	7	2	22.22%	R	Somatic	1.0	0.1107692307692308	0	7	0	2	1	16	0	0
1	202163832	G	C	13	2	13.33%	G	4	6	60%	S	Somatic	1.0	0.0220927813605161	0	4	0	6	2	11	0	2
1	214655823	C	T	72	6	7.69%	C	94	24	20.34%	Y	Somatic	1.0	0.0117314096341975	4	90	0	24	9	63	0	6
1	220426879	T	G	16	0	0%	T	8	2	20%	K	Somatic	1.0	0.1384615384615365	3	5	0	2	9	7	0	0
1	222656414	C	T	8	0	0%	C	5	3	37.5%	Y	Somatic	1.0	0.1000000000000002	4	1	3	0	4	4	0	0
1	228107403	C	T	39	5	11.36%	C	33	15	31.25%	Y	Somatic	1.0	0.0186489873488777	8	25	7	8	13	26	2	3
1	228760156	T	A	11	2	15.38%	T	3	5	62.5%	W	Somatic	1.0	0.0407636738906091	1	2	3	2	8	3	1	1
1	228760242	C	T	16	0	0%	C	10	3	23.08%	Y	Somatic	1.0	0.078270388615217	5	5	0	3	8	8	0	0
1	228773835	A	C	14	0	0%	A	7	2	22.22%	M	Somatic	1.0	0.1422924901185766	2	5	0	2	9	5	0	0
1	246949223	G	A	23	0	0%	G	11	5	31.25%	R	Somatic	1.0	0.0075865339023233	3	8	1	4	11	12	0	0
1	248167130	A	G	41	4	8.89%	A	47	16	25.4%	R	Somatic	1.0	0.0244657774624581	7	40	0	16	7	34	0	4
1	248604452	A	G	225	47	17.28%	A	301	92	23.41%	R	Somatic	1.0	0.0340570995921002	150	151	33	59	132	93	13	34
1	248636481	G	C	32	4	11.11%	G	7	6	46.15%	S	Somatic	1.0	0.0138929814436676	7	0	6	0	30	2	4	0
1	248636484	A	G	36	4	10%	A	8	6	42.86%	R	Somatic	1.0	0.0129864809624473	8	0	6	0	34	2	4	0
1	248636486	A	G	38	5	11.63%	A	9	6	40%	R	Somatic	1.0	0.0250162654521791	9	0	6	0	36	2	5	0
1	248652350	T	C	79	17	17.71%	T	121	50	29.24%	Y	Somatic	1.0	0.0248090330063703	74	47	30	20	44	35	8	9
2	905483	T	G	16	0	0%	T	9	3	25%	K	Somatic	1.0	0.0671550671550672	3	6	3	0	6	10	0	0
2	9546525	C	A	12	2	14.29%	C	3	6	66.67%	M	Somatic	1.0	0.01663627797697	2	1	3	3	9	3	2	0
2	23621521	T	G	12	0	0%	T	7	2	22.22%	K	Somatic	1.0	0.1714285714285741	3	4	0	2	4	8	0	0
2	30866407	A	C	114	12	9.52%	A	85	22	20.56%	M	Somatic	1.0	0.0141448613152747	83	2	22	0	113	1	12	0
2	87581147	A	C	16	0	0%	A	10	3	23.08%	M	Somatic	1.0	0.078270388615217	3	7	0	3	8	8	0	0
2	87581978	C	A	16	0	0%	C	15	7	31.82%	M	Somatic	1.0	0.0135135135135134	3	12	1	6	2	14	0	0
2	87601607	A	G	11	1	8.33%	A	17	23	57.5%	R	Somatic	1.0	0.0026446537630754	1	16	3	20	4	7	0	1
2	87603853	A	G	9	0	0%	A	6	2	25%	R	Somatic	1.0	0.2058823529411773	2	4	0	2	4	5	0	0
2	87604843	C	T	11	0	0%	C	7	3	30%	Y	Somatic	1.0	0.0902255639097742	3	4	0	3	6	5	0	0
2	90376417	A	T	16	0	0%	A	10	3	23.08%	W	Somatic	1.0	0.078270388615217	7	3	1	2	8	8	0	0
2	90386232	A	C	10	0	0%	A	7	2	22.22%	M	Somatic	1.0	0.2105263157894756	5	2	0	2	5	5	0	0
2	90392425	T	C	9	0	0%	T	8	2	20%	Y	Somatic	1.0	0.2631578947368443	3	5	1	1	4	5	0	0
2	90393232	G	A	9	0	0%	G	7	2	22.22%	R	Somatic	1.0	0.235294117647059	2	5	0	2	7	2	0	0
2	91595259	T	G	9	0	0%	T	6	3	33.33%	K	Somatic	1.0	0.1029411764705892	4	2	2	1	8	1	0	0
2	91595287	A	G	10	0	0%	A	7	2	22.22%	R	Somatic	1.0	0.2105263157894756	4	3	0	2	6	4	0	0
2	91597976	G	C	13	0	0%	G	8	4	33.33%	S	Somatic	1.0	0.0391304347826086	6	2	0	4	7	6	0	0
2	91613819	T	A	13	0	0%	T	8	2	20%	W	Somatic	1.0	0.1778656126482181	6	2	1	1	9	4	0	0
2	91729302	C	T	11	0	0%	C	23	8	25.81%	Y	Somatic	1.0	0.0668365045771981	2	21	0	8	1	10	0	0
2	91761338	G	A	12	0	0%	G	10	3	23.08%	R	Somatic	1.0	0.1243478260869566	3	7	2	1	6	6	0	0
2	91761483	A	T	8	0	0%	A	4	4	50%	W	Somatic	1.0	0.0384615384615386	0	4	2	2	3	5	0	0
2	91807920	C	T	9	0	0%	C	7	2	22.22%	Y	Somatic	1.0	0.235294117647059	4	3	1	1	6	3	0	0
2	91815859	A	C	5	0	0%	A	5	3	37.5%	M	Somatic	1.0	0.1958041958041966	2	3	3	0	3	2	0	0
2	91817038	C	T	17	0	0%	C	6	3	33.33%	Y	Somatic	1.0	0.0323076923076925	3	3	2	1	11	6	0	0
2	92310622	T	A	8	0	0%	T	6	2	25%	W	Somatic	1.0	0.2333333333333349	5	1	2	0	7	1	0	0
2	122219914	G	A	9	2	18.18%	G	2	6	75%	A	Somatic	1.0	0.0215527506549177	2	0	5	1	8	1	2	0
2	130988276	C	T	13	0	0%	C	7	3	30%	Y	Somatic	1.0	0.0677583286278935	7	0	2	1	9	4	0	0
2	131006222	C	T	63	10	13.7%	C	56	22	28.21%	Y	Somatic	1.0	0.0230650011944296	21	35	1	21	18	45	0	10
2	133151910	C	A	8	0	0%	C	6	2	25%	M	Somatic	1.0	0.2333333333333349	1	5	1	1	4	4	0	0
2	140941968	G	A	8	0	0%	G	4	3	42.86%	R	Somatic	1.0	0.0769230769230769	0	4	3	0	3	5	0	0
2	195990506	G	A	9	0	0%	G	7	2	22.22%	R	Somatic	1.0	0.235294117647059	7	0	2	0	7	2	0	0
2	196856674	T	C	12	0	0%	T	6	6	50%	Y	Somatic	1.0	0.0068649885583524	2	4	1	5	1	11	0	0
2	201445152	C	T	52	9	14.75%	C	34	16	32%	Y	Somatic	1.0	0.0264889537343917	16	18	8	8	29	23	4	5
2	219188241	T	G	49	0	0%	T	6	2	25%	K	Somatic	1.0	0.0175438596491231	0	6	0	2	2	47	0	0
2	222431664	G	A	10	0	0%	G	6	2	25%	R	Somatic	1.0	0.1830065359477151	6	0	2	0	9	1	0	0
2	222431670	G	A	10	0	0%	G	6	4	40%	R	Somatic	1.0	0.0433436532507745	6	0	4	0	9	1	0	0
2	233630406	G	A	68	8	10.53%	G	56	21	27.27%	R	Somatic	1.0	0.0069094907341865	55	1	21	0	68	0	8	0
2	233630409	T	A	73	9	10.98%	T	60	21	25.93%	W	Somatic	1.0	0.0113791966688374	59	1	21	0	73	0	9	0
2	233630449	T	A	134	12	8.22%	T	121	33	21.43%	W	Somatic	1.0	0.0010137517696994	116	5	29	4	124	10	12	0
2	233630453	G	A	137	12	8.05%	G	125	33	20.89%	R	Somatic	1.0	0.0011024645551379	120	5	29	4	125	12	12	0
2	233630454	T	G	137	12	8.05%	T	125	33	20.89%	K	Somatic	1.0	0.0011024645551379	120	5	29	4	124	13	12	0
2	233880641	T	C	26	0	0%	T	17	5	22.73%	Y	Somatic	1.0	0.015379278445883	0	17	0	5	0	26	0	0
2	239007274	G	A	137	14	9.27%	G	140	80	36.36%	R	Somatic	1.0	7.550458462236108e-10	93	47	67	13	90	47	1	13
2	239007276	G	A	138	13	8.61%	G	141	79	35.91%	R	Somatic	1.0	3.8088135253141845e-10	93	48	66	13	91	47	0	13
2	239007281	C	T	130	0	0%	C	148	78	34.51%	Y	Somatic	1.0	9.912706400859205e-19	94	54	69	9	78	52	0	0
3	19977558	G	A	21	0	0%	G	8	2	20%	R	Somatic	1.0	0.0967741935483852	8	0	2	0	19	2	0	0
3	32509832	G	A	15	0	0%	G	7	2	22.22%	R	Somatic	1.0	0.1304347826086963	7	0	2	0	15	0	0	0
3	49049501	T	G	241	35	12.68%	T	284	75	20.89%	K	Somatic	1.0	0.0042601767007308	92	192	75	0	72	169	35	0
3	52006031	C	T	32	0	0%	C	8	2	20%	Y	Somatic	1.0	0.0522648083623699	0	8	0	2	1	31	0	0
3	75419725	A	C	9	0	0%	A	12	3	20%	M	Somatic	1.0	0.224802371541498	0	12	0	3	0	9	0	0
3	78250440	G	C	12	0	0%	G	14	6	30%	S	Somatic	1.0	0.04277239260554	10	4	5	1	6	6	0	0
3	94225343	G	T	8	0	0%	G	8	7	46.67%	K	Somatic	1.0	0.0262484856642886	8	0	6	1	6	2	0	0
3	97851892	G	A	19	0	0%	G	13	4	23.53%	R	Somatic	1.0	0.0404040404040398	7	6	4	0	15	4	0	0
3	97916391	A	C	12	3	20%	M	4	11	73.33%	M	Somatic	1.0	0.0046102851566992	3	1	5	6	6	6	2	1
3	133479499	T	G	8	2	20%	K	3	8	72.73%	K	Somatic	1.0	0.0226414452420646	3	0	7	1	6	2	1	1
3	148899784	G	C	13	0	0%	G	7	2	22.22%	S	Somatic	1.0	0.1558441558441554	2	5	2	0	8	5	0	0
3	168867767	C	G	7	0	0%	C	6	2	25%	S	Somatic	1.0	0.2666666666666675	1	5	1	1	1	6	0	0
3	170658522	A	G	12	0	0%	A	6	2	25%	R	Somatic	1.0	0.1473684210526336	3	3	2	0	10	2	0	0
3	178956018	A	G	15	0	0%	A	15	5	25%	R	Somatic	1.0	0.047758692919984	1	14	0	5	1	14	0	0
3	195440942	G	A	9	0	0%	G	7	2	22.22%	R	Somatic	1.0	0.235294117647059	1	6	2	0	3	6	0	0
3	195572086	T	C	14	3	17.65%	T	3	6	66.67%	Y	Somatic	1.0	0.0198972652061896	0	3	0	6	2	12	0	3
4	548952	C	G	8	0	0%	C	8	4	33.33%	S	Somatic	1.0	0.1021671826625396	2	6	2	2	6	2	0	0
4	549086	A	C	7	0	0%	A	6	2	25%	M	Somatic	1.0	0.2666666666666675	2	4	0	2	4	3	0	0
4	1672815	G	A	10	0	0%	G	4	3	42.86%	R	Somatic	1.0	0.0514705882352941	1	3	1	2	5	5	0	0
4	3543403	G	A	8	0	0%	G	8	3	27.27%	R	Somatic	1.0	0.1702786377708978	7	1	3	0	4	4	0	0
4	3543444	G	A	9	0	0%	G	9	4	30.77%	R	Somatic	1.0	0.0977443609022545	4	5	2	2	5	4	0	0
4	7726594	G	A	17	0	0%	G	6	2	25%	R	Somatic	1.0	0.0933333333333325	5	1	1	1	15	2	0	0
4	9240515	A	G	8	1	11.11%	A	5	8	61.54%	R	Somatic	1.0	0.0247235736399822	2	3	6	2	2	6	1	0
4	9252117	A	G	8	0	0%	A	7	2	22.22%	R	Somatic	1.0	0.2647058823529424	3	4	0	2	5	3	0	0
4	9982837	A	G	13	0	0%	A	8	6	42.86%	R	Somatic	1.0	0.0101449275362318	3	5	3	3	6	7	0	0
4	9982852	A	C	11	0	0%	A	11	3	21.43%	M	Somatic	1.0	0.1582608695652178	5	6	3	0	2	9	0	0
4	9982856	C	T	11	0	0%	C	11	3	21.43%	Y	Somatic	1.0	0.1582608695652178	6	5	3	0	2	9	0	0
4	9982857	T	G	12	0	0%	T	11	3	21.43%	K	Somatic	1.0	0.1400000000000002	6	5	3	0	2	10	0	0
4	9982872	G	A	10	0	0%	G	12	6	33.33%	R	Somatic	1.0	0.049275362318841	5	7	6	0	1	9	0	0
4	42162425	C	T	8	2	20%	Y	5	10	66.67%	Y	Somatic	1.0	0.0286983443262888	5	0	10	0	6	2	1	1
4	49094145	G	A	8	0	0%	G	6	4	40%	R	Somatic	1.0	0.0686274509803926	3	3	3	1	5	3	0	0
4	49261231	C	T	12	0	0%	C	7	2	22.22%	Y	Somatic	1.0	0.1714285714285741	4	3	1	1	7	5	0	0
4	74702241	A	C	13	0	0%	A	6	3	33.33%	M	Somatic	1.0	0.0545454545454545	6	0	3	0	11	2	0	0
4	88537135	T	C	7	0	0%	T	7	3	30%	Y	Somatic	1.0	0.1764705882352944	6	1	0	3	7	0	0	0
4	132656293	C	G	12	0	0%	C	10	3	23.08%	S	Somatic	1.0	0.1243478260869566	5	5	0	3	7	5	0	0
4	145041036	G	A	15	2	11.76%	G	7	9	56.25%	R	Somatic	1.0	0.0087649723525333	1	6	0	9	2	13	0	2
4	182160643	A	G	11	0	0%	A	9	3	25%	R	Somatic	1.0	0.1242236024844708	4	5	1	2	6	5	0	0
4	182161152	A	G	12	0	0%	A	6	2	25%	R	Somatic	1.0	0.1473684210526336	3	3	1	1	7	5	0	0
4	182161203	A	G	14	0	0%	A	6	2	25%	R	Somatic	1.0	0.1212121212121225	4	2	1	1	7	7	0	0
4	190076536	C	G	15	1	6.25%	C	10	6	37.5%	S	Somatic	1.0	0.041465826226672	1	9	4	2	8	7	1	0
5	184106	C	A	28	0	0%	C	47	35	42.68%	M	Somatic	1.0	2.8711317529693927e-06	7	40	6	29	3	25	0	0
5	710726	T	A	472	94	16.61%	T	330	139	29.64%	W	Somatic	1.0	4.3974530324009785e-07	231	99	117	22	244	228	54	40
5	711023	T	A	199	0	0%	T	224	73	24.58%	W	Somatic	1.0	9.179724388118452e-19	108	116	27	46	110	89	0	0
5	711030	A	G	126	1	0.79%	A	122	139	53.26%	R	Somatic	1.0	2.087475605054488e-30	62	60	54	85	64	62	0	1
5	711032	G	A	127	0	0%	G	179	80	30.89%	R	Somatic	1.0	1.0513703870038991e-16	87	92	27	53	61	66	0	0
5	711035	A	G	127	0	0%	A	121	95	43.98%	R	Somatic	1.0	3.1509096583132322e-24	60	61	33	62	62	65	0	0
5	768547	T	C	8	0	0%	T	6	2	25%	Y	Somatic	1.0	0.2333333333333349	3	3	1	1	6	2	0	0
5	796272	T	A	257	56	17.89%	T	238	86	26.54%	W	Somatic	1.0	0.0056332096966117	57	181	34	52	77	180	28	28
5	796277	T	C	234	56	19.31%	T	207	87	29.59%	Y	Somatic	1.0	0.0025538345870176	52	155	33	54	68	166	27	29
5	845360	C	T	9	0	0%	C	6	2	25%	Y	Somatic	1.0	0.2058823529411773	3	3	0	2	5	4	0	0
5	1539884	C	T	9	0	0%	C	9	3	25%	Y	Somatic	1.0	0.1654135338345876	8	1	1	2	5	4	0	0
5	1539944	C	T	8	0	0%	C	12	4	25%	Y	Somatic	1.0	0.1712779973649559	5	7	3	1	4	4	0	0
5	1540034	C	T	8	0	0%	C	6	2	25%	Y	Somatic	1.0	0.2333333333333349	0	6	2	0	7	1	0	0
5	2146002	C	A	10	0	0%	C	12	3	20%	M	Somatic	1.0	0.1978260869565221	7	5	3	0	4	6	0	0
5	2146968	T	C	10	0	0%	T	8	2	20%	Y	Somatic	1.0	0.2368421052631576	3	5	2	0	2	8	0	0
5	2147021	C	A	9	0	0%	C	8	2	20%	M	Somatic	1.0	0.2631578947368443	2	6	2	0	1	8	0	0
6	143318	T	C	9	0	0%	T	10	3	23.08%	Y	Somatic	1.0	0.1857142857142844	7	3	1	2	6	3	0	0
6	54074949	C	T	19	0	0%	C	218	250	53.42%	Y	Somatic	1.0	7.758747273169846e-07	171	47	200	50	17	2	0	0
13	72249539	C	G	9	0	0%	C	9	5	35.71%	S	Somatic	1.0	0.0594965675057212	4	5	1	4	4	5	0	0
GL000247.1	5872	T	G	17	0	0%	T	8	6	42.86%	K	Somatic	1.0	0.0040786058583611	1	7	0	6	5	12	0	0
hs37d5	1083939	T	C	3	0	0%	T	6	2	25%	Y	Somatic	1.0	0.5090909090909078	4	2	1	1	1	2	0	0
hs37d5	1092414	T	A	24	2	7.69%	T	6	4	40%	W	Somatic	1.0	0.0385112989477314	1	5	1	3	12	12	2	0
hs37d5	1092480	T	C	21	2	8.7%	T	5	6	54.55%	Y	Somatic	1.0	0.0068649261706907	3	2	6	0	8	13	1	1
hs37d5	1092582	T	C	10	0	0%	T	9	4	30.77%	Y	Somatic	1.0	0.080745341614906	3	6	1	3	2	8	0	0
hs37d5	1167485	A	G	8	0	0%	A	13	4	23.53%	R	Somatic	1.0	0.1881422924901176	5	8	4	0	3	5	0	0
hs37d5	1447284	A	G	19	0	0%	A	10	3	23.08%	R	Somatic	1.0	0.0576612903225824	4	6	2	1	2	17	0	0
hs37d5	2695552	C	T	9	0	0%	C	10	3	23.08%	Y	Somatic	1.0	0.1857142857142844	4	6	2	1	6	3	0	0
hs37d5	2695611	C	T	10	2	16.67%	C	4	6	60%	Y	Somatic	1.0	0.0479876160990718	0	4	2	4	4	6	1	1
hs37d5	4747152	T	A	20	0	0%	T	6	2	25%	W	Somatic	1.0	0.0740740740740736	3	3	1	1	10	10	0	0
hs37d5	4751607	C	T	8	0	0%	C	8	2	20%	Y	Somatic	1.0	0.2941176470588277	4	4	2	0	4	4	0	0
hs37d5	4751660	G	C	13	0	0%	G	8	2	20%	S	Somatic	1.0	0.1778656126482181	5	3	2	0	8	5	0	0
hs37d5	4762892	C	A	24	3	11.11%	C	12	7	36.84%	M	Somatic	1.0	0.0432987225756472	11	1	4	3	22	2	1	2
hs37d5	4762919	T	G	23	3	11.54%	T	12	7	36.84%	K	Somatic	1.0	0.0495479236261992	7	5	3	4	11	12	1	2
hs37d5	4766011	C	A	34	0	0%	C	12	3	20%	M	Somatic	1.0	0.0246960486322193	5	7	1	2	11	23	0	0
hs37d5	4773305	G	T	35	1	2.78%	G	8	3	27.27%	K	Somatic	1.0	0.0351526364477321	1	7	0	3	2	33	0	1
hs37d5	4782789	C	G	17	0	0%	C	12	3	20%	S	Somatic	1.0	0.0917338709677422	5	7	2	1	8	9	0	0
hs37d5	4816944	G	C	20	0	0%	G	6	2	25%	S	Somatic	1.0	0.0740740740740736	4	2	1	1	11	9	0	0
hs37d5	4817196	C	A	20	0	0%	C	9	3	25%	M	Somatic	1.0	0.0443548387096774	7	2	1	2	9	11	0	0
hs37d5	4828578	A	G	19	0	0%	A	6	2	25%	R	Somatic	1.0	0.0797720797720796	3	3	2	0	9	10	0	0
hs37d5	4834280	G	T	8	0	0%	G	6	2	25%	K	Somatic	1.0	0.2333333333333349	3	3	2	0	4	4	0	0
hs37d5	4887020	A	G	10	0	0%	A	7	2	22.22%	R	Somatic	1.0	0.2105263157894756	5	2	2	0	5	5	0	0
hs37d5	4890053	C	G	16	0	0%	C	8	3	27.27%	S	Somatic	1.0	0.0564102564102557	6	2	2	1	14	2	0	0
hs37d5	4898451	G	C	11	0	0%	G	6	2	25%	S	Somatic	1.0	0.1637426900584798	4	2	2	0	6	5	0	0
hs37d5	7897569	C	A	10	0	0%	C	7	2	22.22%	M	Somatic	1.0	0.2105263157894756	6	1	2	0	6	4	0	0
hs37d5	7898401	C	T	8	0	0%	C	6	2	25%	Y	Somatic	1.0	0.2333333333333349	5	1	2	0	6	2	0	0
hs37d5	8262856	G	T	11	0	0%	G	6	2	25%	K	Somatic	1.0	0.1637426900584798	0	6	0	2	0	11	0	0
hs37d5	8263654	G	C	11	0	0%	G	10	3	23.08%	S	Somatic	1.0	0.1413043478260863	4	6	1	2	6	5	0	0
hs37d5	8264374	C	T	13	0	0%	C	6	2	25%	Y	Somatic	1.0	0.1333333333333354	3	3	2	0	8	5	0	0
hs37d5	8487717	A	C	99	11	10%	A	44	12	21.43%	M	Somatic	1.0	0.040048019622845	22	22	5	7	48	51	4	7
hs37d5	12379551	T	C	17	0	0%	T	12	3	20%	Y	Somatic	1.0	0.0917338709677422	6	6	2	1	3	14	0	0
hs37d5	12380635	T	G	9	0	0%	T	7	2	22.22%	K	Somatic	1.0	0.235294117647059	1	6	0	2	2	7	0	0
hs37d5	12421377	C	T	13	0	0%	C	8	2	20%	Y	Somatic	1.0	0.1778656126482181	1	7	1	1	2	11	0	0
hs37d5	12576967	G	C	8	0	0%	G	6	2	25%	S	Somatic	1.0	0.2333333333333349	4	2	0	2	2	6	0	0
hs37d5	12577051	C	T	10	0	0%	C	8	2	20%	Y	Somatic	1.0	0.2368421052631576	5	3	0	2	5	5	0	0
hs37d5	13244144	T	G	9	0	0%	T	6	2	25%	K	Somatic	1.0	0.2058823529411773	3	3	0	2	2	7	0	0
hs37d5	16046129	A	T	16	0	0%	A	9	3	25%	W	Somatic	1.0	0.0671550671550672	9	0	3	0	16	0	0	0
hs37d5	16661743	G	C	10	0	0%	G	8	2	20%	S	Somatic	1.0	0.2368421052631576	4	4	0	2	2	8	0	0
hs37d5	16663549	A	T	8	0	0%	A	7	2	22.22%	W	Somatic	1.0	0.2647058823529424	0	7	0	2	2	6	0	0
hs37d5	19351153	A	C	11	0	0%	A	8	2	20%	M	Somatic	1.0	0.2142857142857145	3	5	1	1	3	8	0	0
hs37d5	19353243	G	A	32	0	0%	G	8	2	20%	R	Somatic	1.0	0.0522648083623699	1	7	0	2	7	25	0	0
hs37d5	19374118	C	A	15	0	0%	C	8	2	20%	M	Somatic	1.0	0.1499999999999986	7	1	2	0	14	1	0	0
hs37d5	19375567	A	G	14	0	0%	A	6	2	25%	R	Somatic	1.0	0.1212121212121225	6	0	2	0	14	0	0	0
hs37d5	19563620	G	T	52	0	0%	G	7	2	22.22%	K	Somatic	1.0	0.0196721311475414	1	6	0	2	5	47	0	0
hs37d5	19813409	G	A	19	2	9.52%	G	5	4	44.44%	R	Somatic	1.0	0.0491600353669319	5	0	2	2	17	2	2	0
hs37d5	20771115	C	A	6	0	0%	C	6	2	25%	M	Somatic	1.0	0.3076923076923067	2	4	0	2	1	5	0	0
hs37d5	20823635	A	C	84	16	16%	A	41	18	30.51%	M	Somatic	1.0	0.0263652291636592	12	29	4	14	23	61	2	14
hs37d5	20824990	C	A	24	0	0%	C	5	2	28.57%	M	Somatic	1.0	0.0451612903225808	3	2	2	0	7	17	0	0
hs37d5	20825403	C	T	14	0	0%	C	12	3	20%	Y	Somatic	1.0	0.1245210727969345	2	10	0	3	10	4	0	0
hs37d5	20825515	A	T	20	0	0%	A	8	2	20%	W	Somatic	1.0	0.1034482758620701	5	3	1	1	6	14	0	0
hs37d5	21115174	G	A	10	0	0%	G	8	2	20%	R	Somatic	1.0	0.2368421052631576	0	8	0	2	0	10	0	0
hs37d5	21262249	A	G	8	0	0%	A	8	2	20%	R	Somatic	1.0	0.2941176470588277	5	3	2	0	4	4	0	0
hs37d5	22570307	C	G	58	6	9.38%	C	16	6	27.27%	S	Somatic	1.0	0.0465632430360328	2	14	0	6	2	56	0	6
hs37d5	22841060	A	T	159	22	12.15%	A	69	24	25.81%	W	Somatic	1.0	0.0041252218088002	64	5	22	2	143	16	22	0
hs37d5	22841825	C	G	9	0	0%	C	6	2	25%	S	Somatic	1.0	0.2058823529411773	1	5	0	2	5	4	0	0
hs37d5	23571543	G	T	16	0	0%	G	6	2	25%	K	Somatic	1.0	0.1014492753623192	0	6	0	2	0	16	0	0
hs37d5	23590047	T	G	8	2	20%	K	7	16	69.57%	K	Somatic	1.0	0.0116425658138671	0	7	4	12	1	7	0	2
hs37d5	23871046	C	G	11	0	0%	C	6	2	25%	S	Somatic	1.0	0.1637426900584798	4	2	1	1	5	6	0	0
hs37d5	24072352	T	C	10	0	0%	T	7	2	22.22%	Y	Somatic	1.0	0.2105263157894756	5	2	0	2	9	1	0	0
hs37d5	24127006	G	C	40	2	4.76%	G	11	4	26.67%	S	Somatic	1.0	0.0360005216013162	0	11	0	4	8	32	1	1
hs37d5	24685360	T	A	25	0	0%	T	11	4	26.67%	W	Somatic	1.0	0.0149359886201994	3	8	1	3	11	14	0	0
hs37d5	24686123	A	T	12	0	0%	A	5	2	28.57%	W	Somatic	1.0	0.1228070175438599	1	4	0	2	4	8	0	0
hs37d5	24793379	T	C	9	0	0%	T	6	2	25%	Y	Somatic	1.0	0.2058823529411773	5	1	2	0	6	3	0	0
hs37d5	25813337	A	T	12	0	0%	A	6	2	25%	W	Somatic	1.0	0.1473684210526336	1	5	0	2	6	6	0	0
hs37d5	26026177	A	T	128	29	18.47%	A	81	33	28.95%	W	Somatic	1.0	0.0304822794856507	69	12	31	2	103	25	27	2
hs37d5	26028215	G	T	10	0	0%	G	6	2	25%	K	Somatic	1.0	0.1830065359477151	4	2	1	1	8	2	0	0
hs37d5	26164708	G	A	18	3	14.29%	G	3	6	66.67%	R	Somatic	1.0	0.0083503702694106	2	1	6	0	13	5	1	2
hs37d5	26164953	G	T	13	0	0%	G	6	2	25%	K	Somatic	1.0	0.1333333333333354	4	2	1	1	5	8	0	0
hs37d5	26170292	G	C	13	0	0%	G	6	2	25%	S	Somatic	1.0	0.1333333333333354	4	2	1	1	10	3	0	0
hs37d5	26171041	A	C	184	29	13.62%	A	95	27	22.13%	M	Somatic	1.0	0.0327973700382176	82	13	23	4	151	33	28	1
hs37d5	26173080	A	C	10	0	0%	A	6	2	25%	M	Somatic	1.0	0.1830065359477151	3	3	1	1	5	5	0	0
hs37d5	26230488	A	C	48	0	0%	A	7	2	22.22%	M	Somatic	1.0	0.0225563909774431	1	6	0	2	8	40	0	0
hs37d5	26230499	T	C	41	0	0%	T	5	3	37.5%	Y	Somatic	1.0	0.0030395136778115	0	5	1	2	4	37	0	0
hs37d5	26299921	T	C	13	0	0%	T	8	2	20%	Y	Somatic	1.0	0.1778656126482181	4	4	0	2	1	12	0	0
hs37d5	27578601	C	T	12	0	0%	C	7	2	22.22%	Y	Somatic	1.0	0.1714285714285741	6	1	2	0	6	6	0	0
hs37d5	27814373	A	T	192	32	14.29%	A	117	34	22.52%	W	Somatic	1.0	0.0284757103380563	91	26	25	9	149	43	27	5
hs37d5	27904387	G	T	15	0	0%	G	6	2	25%	K	Somatic	1.0	0.1106719367588929	4	2	0	2	4	11	0	0
hs37d5	27904395	C	A	14	0	0%	C	5	2	28.57%	M	Somatic	1.0	0.1000000000000009	2	3	0	2	3	11	0	0
hs37d5	27932567	C	T	17	0	0%	C	8	3	27.27%	Y	Somatic	1.0	0.0503663003663008	7	1	2	1	14	3	0	0
hs37d5	28330736	T	C	9	0	0%	T	7	2	22.22%	Y	Somatic	1.0	0.235294117647059	4	3	2	0	5	4	0	0
hs37d5	28330811	C	A	8	0	0%	C	8	2	20%	M	Somatic	1.0	0.2941176470588277	4	4	1	1	3	5	0	0
hs37d5	28351019	C	T	34	0	0%	C	8	2	20%	Y	Somatic	1.0	0.0475687103594077	4	4	1	1	21	13	0	0
hs37d5	29159647	T	G	6	0	0%	T	7	2	22.22%	K	Somatic	1.0	0.3428571428571441	5	2	2	0	5	1	0	0
hs37d5	29161778	A	T	15	0	0%	A	11	3	21.43%	W	Somatic	1.0	0.0996168582375477	8	3	2	1	4	11	0	0
hs37d5	29337163	A	G	17	0	0%	A	11	4	26.67%	R	Somatic	1.0	0.0379588431590663	8	3	4	0	13	4	0	0
hs37d5	29428380	C	T	20	0	0%	C	6	2	25%	Y	Somatic	1.0	0.0740740740740736	3	3	0	2	4	16	0	0
hs37d5	29915374	G	A	75	8	9.64%	G	30	9	23.08%	R	Somatic	1.0	0.0458088693777215	27	3	7	2	68	7	7	1
hs37d5	30001599	A	T	15	0	0%	A	5	2	28.57%	W	Somatic	1.0	0.09090909090909	0	5	1	1	4	11	0	0
hs37d5	30080885	C	T	13	0	0%	C	8	2	20%	Y	Somatic	1.0	0.1778656126482181	1	7	0	2	1	12	0	0
hs37d5	30884129	G	A	11	0	0%	G	7	2	22.22%	R	Somatic	1.0	0.1894736842105263	0	7	1	1	1	10	0	0
1	22985785	A	-GATG	7	0	0%	A	6	6	50%	*/-GATG	Somatic	1.0	0.0340557275541794	5	1	6	0	7	0	0	0
1	29016714	T	+G	72	1	1.37%	T	9	50	84.75%	+G/+G	Somatic	1.0	7.393950853795397e-26	0	9	5	45	10	62	0	1
1	53289190	G	+T	88	10	10.2%	G	17	7	29.17%	*/+T	Somatic	1.0	0.0243071204010591	11	6	7	0	56	32	7	3
1	67487393	C	-AG	8	0	0%	C	8	2	20%	*/-AG	Somatic	1.0	0.2941176470588277	0	8	0	2	0	8	0	0
1	74901739	C	-T	44	8	15.38%	C	17	11	39.29%	*/-T	Somatic	1.0	0.0182099061042509	17	0	11	0	44	0	8	0
1	117628869	A	+TG	33	7	17.5%	A	32	23	41.82%	*/+TG	Somatic	1.0	0.0099000270874014	32	0	23	0	33	0	7	0
1	118502732	C	+GTGT	110	7	5.98%	C	86	27	23.89%	*/+GTGT	Somatic	1.0	9.959390275543904e-05	44	42	18	9	35	75	1	6
1	142805095	T	-CTGC	8	0	0%	T	7	2	22.22%	*/-CTGC	Somatic	1.0	0.2647058823529424	5	2	0	2	5	3	0	0
1	145515057	C	+A	60	2	3.23%	C	9	3	25%	*/+A	Somatic	1.0	0.027780033278779	9	0	3	0	58	2	2	0
1	147229628	G	+GGGCATTTGCCAGAGGTACATACCA	349	0	0%	G	422	168	28.47%	*/+GGGCATTTGCCAGAGGTACATACCA	Somatic	1.0	3.4412407250964946e-39	227	195	69	99	170	179	0	0
1	153608885	C	+A	32	2	5.88%	C	5	6	54.55%	*/+A	Somatic	1.0	0.001255221477928	5	0	6	0	30	2	2	0
1	159684047	C	-CACACACA	23	3	11.54%	C	27	15	35.71%	*/-CACACACA	Somatic	1.0	0.0249397239352822	5	22	2	13	2	21	1	2
1	163116030	C	-T	197	38	16.17%	C	132	40	23.26%	*/-T	Somatic	1.0	0.0483031636145943	66	66	22	18	117	80	20	18
1	175129924	C	+CTT	291	62	17.56%	C	226	88	28.03%	*/+CTT	Somatic	1.0	0.0008505754837322315	82	144	41	47	112	179	28	34
1	204392575	C	-A	52	6	10.34%	C	15	7	31.82%	*/-A	Somatic	1.0	0.0272905736810724	14	1	7	0	51	1	5	1
1	207077642	C	-T	30	0	0%	C	10	6	37.5%	*/-T	Somatic	1.0	0.0008549327151511979	9	1	6	0	29	1	0	0
1	220205693	G	-T	38	0	0%	G	8	2	20%	*/-T	Somatic	1.0	0.0398936170212756	6	2	2	0	36	2	0	0
1	228748995	G	-ACTC	13	0	0%	G	7	2	22.22%	*/-ACTC	Somatic	1.0	0.1558441558441554	4	3	1	1	9	4	0	0
1	228760153	G	-ACTC	16	0	0%	G	9	3	25%	*/-ACTC	Somatic	1.0	0.0671550671550672	4	5	2	1	10	6	0	0
2	11273123	T	+CACACA	8	0	0%	T	13	4	23.53%	*/+CACACA	Somatic	1.0	0.1881422924901176	12	1	4	0	7	1	0	0
2	49381711	T	-TTG	36	0	0%	T	22	7	24.14%	*/-TTG	Somatic	1.0	0.0022418861870232	10	12	7	0	12	24	0	0
2	69626342	C	+A	28	1	3.45%	C	11	4	26.67%	*/+A	Somatic	1.0	0.0392151807353171	11	0	4	0	28	0	1	0
2	74089266	G	-A	30	4	11.76%	G	5	4	44.44%	*/-A	Somatic	1.0	0.0458298403487532	5	0	4	0	30	0	4	0
2	91675329	A	-T	12	0	0%	A	8	2	20%	*/-T	Somatic	1.0	0.1948051948051969	3	5	1	1	5	7	0	0
2	111886180	C	-TT	12	2	14.29%	C	3	5	62.5%	*/-TT	Somatic	1.0	0.0322262876442444	3	0	5	0	12	0	2	0
2	118850785	A	-GATGAT	7	0	0%	A	7	3	30%	*/-GATGAT	Somatic	1.0	0.1764705882352944	5	2	0	3	5	2	0	0
2	118850939	A	-GATGAT	9	0	0%	A	8	3	27.27%	*/-GATGAT	Somatic	1.0	0.1447368421052647	3	5	0	3	3	6	0	0
2	152105885	T	-TC	32	0	0%	T	4	4	50%	*/-TC	Somatic	1.0	0.0007659481343691921	1	3	1	3	7	25	0	0
2	153463984	T	-ACAC	35	3	7.89%	T	56	18	24.32%	*/-ACAC	Somatic	1.0	0.0275490035863682	5	51	0	18	0	35	0	3
2	162866023	T	-TGTG	17	0	0%	T	8	2	20%	*/-TGTG	Somatic	1.0	0.128205128205128	0	8	0	2	2	15	0	0
2	222431674	A	-GGG	10	0	0%	A	6	4	40%	*/-GGG	Somatic	1.0	0.0433436532507745	6	0	4	0	9	1	0	0
2	225719534	G	-A	40	1	2.44%	G	11	3	21.43%	*/-A	Somatic	1.0	0.0466933485801392	11	0	3	0	40	0	1	0
2	231861032	T	-CAGCAGCCTAGCCCTGAATCCACACCA	495	97	16.39%	T	57	450	88.76%	-CAGCAGCCTAGCCCTGAATCCACACCA/-CAGCAGCCTAGCCCTGAATCCACACCA	Somatic	1.0	1.876150581519892e-140	34	23	313	137	362	133	66	31
2	234418484	T	-A	17	0	0%	T	6	3	33.33%	*/-A	Somatic	1.0	0.0323076923076925	6	0	3	0	17	0	0	0
2	240158529	A	+AG	20	0	0%	A	8	2	20%	*/+AG	Somatic	1.0	0.1034482758620701	0	8	0	2	0	20	0	0
2	240898617	A	-CACAGGGGATGATCAGAG	194	35	15.28%	A	299	87	22.54%	*/-CACAGGGGATGATCAGAG	Somatic	1.0	0.0179245088174843	129	170	44	43	85	109	21	14
3	14106310	T	+CCAGCACCAGCAGTC	38	0	0%	T	7	8	53.33%	*/+CCAGCACCAGCAGTC	Somatic	1.0	7.260335233878543e-06	2	5	3	5	22	16	0	0
3	40550121	C	-T	32	1	3.03%	C	8	3	27.27%	*/-T	Somatic	1.0	0.0425411230856499	8	0	3	0	32	0	1	0
3	42251577	C	+GGA	147	26	15.03%	C	101	45	30.82%	*/+GGA	Somatic	1.0	0.0005859031442366756	67	34	39	6	79	68	19	7
3	48681765	C	-AG	53	2	3.64%	C	32	12	27.27%	*/-AG	Somatic	1.0	0.000902349421043168	6	26	1	11	11	42	0	2
3	89448884	T	+TTA	204	1	0.49%	T	81	52	39.1%	*/+TTA	Somatic	1.0	1.931811147422035e-23	22	59	15	37	70	134	1	0
3	93794574	G	+C	16	2	11.11%	G	5	6	54.55%	*/+C	Somatic	1.0	0.0178910544727635	3	2	4	2	10	6	2	0
3	100515197	A	+T	62	0	0%	A	7	2	22.22%	*/+T	Somatic	1.0	0.0144869215291747	7	0	2	0	61	1	0	0
3	133665977	C	-A	8	0	0%	C	7	2	22.22%	*/-A	Somatic	1.0	0.2647058823529424	7	0	2	0	8	0	0	0
3	158537415	C	-T	63	8	11.27%	C	11	6	35.29%	*/-T	Somatic	1.0	0.025085806195657	11	0	5	1	63	0	8	0
3	175189406	C	-T	162	0	0%	C	2	134	98.53%	-T/-T	Somatic	1.0	1.7626069836832347e-84	2	0	127	7	148	14	0	0
3	183823867	A	+AAGC	13	0	0%	A	7	2	22.22%	*/+AAGC	Somatic	1.0	0.1558441558441554	3	4	0	2	2	11	0	0
3	197060818	A	+AGCAGCAGC	11	1	8.33%	A	11	8	42.11%	*/+AGCAGCAGC	Somatic	1.0	0.0495713433605775	7	4	3	5	8	3	1	0
4	2841961	C	+A	43	1	2.27%	C	10	3	23.08%	*/+A	Somatic	1.0	0.0336675020885544	10	0	3	0	42	1	1	0
4	7726655	G	-GTA	7	1	12.5%	G	4	7	63.64%	*/-GTA	Somatic	1.0	0.0371120107962213	4	0	7	0	7	0	1	0
4	8451680	T	+C	48	0	0%	T	13	43	76.79%	+C/+C	Somatic	1.0	5.6272646680378935e-18	0	13	1	42	1	47	0	0
4	9982875	A	-ATG	10	0	0%	A	14	4	22.22%	*/-ATG	Somatic	1.0	0.1494505494505497	7	7	4	0	1	9	0	0
4	38907021	T	-A	35	3	7.89%	T	6	4	40%	*/-A	Somatic	1.0	0.0265766761259731	5	1	4	0	31	4	3	0
4	47595998	C	-A	21	4	16%	C	3	4	57.14%	*/-A	Somatic	1.0	0.046887329701568	2	1	0	4	18	3	3	1
4	49323458	A	+GCAC	20	0	0%	A	8	3	27.27%	*/+GCAC	Somatic	1.0	0.0367074527252498	4	4	3	0	17	3	0	0
4	76871287	C	-G	28	0	0%	C	7	2	22.22%	*/-G	Somatic	1.0	0.0540540540540556	6	1	2	0	27	1	0	0
4	88532182	A	+GTGT	8	0	0%	A	9	5	35.71%	*/+GTGT	Somatic	1.0	0.0760233918128667	1	8	0	5	0	8	0	0
4	88533163	T	-TGTGTG	13	3	18.75%	T	21	20	48.78%	*/-TGTGTG	Somatic	1.0	0.0352408067929359	21	0	19	1	12	1	3	0
4	128922994	T	-TG	16	2	11.11%	T	3	10	76.92%	-TG/-TG	Somatic	1.0	0.0003201164394761099	0	3	0	10	2	14	0	2
4	146806762	C	-AGAGAGAG	21	2	8.7%	C	10	6	37.5%	*/-AGAGAGAG	Somatic	1.0	0.037416673639583	10	0	6	0	20	1	1	1
4	169922302	A	-T	40	5	11.11%	A	10	7	41.18%	*/-T	Somatic	1.0	0.0128452065331618	9	1	7	0	37	3	5	0
4	176733447	T	-GGG	168	2	1.18%	T	40	63	61.17%	*/-GGG	Somatic	1.0	1.314111188798976e-31	2	38	8	55	42	126	0	2
4	186319948	C	-A	38	7	15.56%	C	13	8	38.1%	*/-A	Somatic	1.0	0.0451479845181941	13	0	8	0	38	0	7	0
4	189019277	G	-A	77	14	15.38%	G	27	12	30.77%	*/-A	Somatic	1.0	0.0408393727348573	24	3	9	3	65	12	12	2
5	796343	C	+TCT	113	15	11.72%	C	76	20	20.83%	*/+TCT	Somatic	1.0	0.0477017620489078	2	74	1	19	5	108	2	13
5	4095683	C	+T	20	0	0%	C	10	5	33.33%	*/+T	Somatic	1.0	0.0092504743833016	0	10	0	5	0	20	0	0
5	7301374	C	-CCGCATCTGCTGCTCCCGCTT	242	0	0%	C	6	30	83.33%	-CCGCATCTGCTGCTCCCGCTT/-CCGCATCTGCTGCTCCCGCTT	Somatic	1.0	1.2497406032088974e-34	6	0	15	15	226	16	0	0
5	7724521	G	+TT	45	0	0%	G	6	3	33.33%	*/+TT	Somatic	1.0	0.0033865505563618	6	0	3	0	45	0	0	0
hs37d5	8266054	A	-GT	23	2	8%	A	4	4	50%	*/-GT	Somatic	1.0	0.0202497724744663	0	4	0	4	1	22	0	2
hs37d5	12370062	G	+GAAT	19	0	0%	G	16	4	20%	*/+GAAT	Somatic	1.0	0.0589050589050589	13	3	4	0	16	3	0	0
hs37d5	12379613	A	-ATC	12	0	0%	A	6	3	33.33%	*/-ATC	Somatic	1.0	0.0631578947368422	0	6	0	3	1	11	0	0
hs37d5	12421372	C	-GA	14	0	0%	C	8	2	20%	*/-GA	Somatic	1.0	0.1630434782608678	1	7	1	1	3	11	0	0
hs37d5	23695076	C	+T	22	0	0%	C	6	2	25%	*/+T	Somatic	1.0	0.0643678160919529	2	4	2	0	5	17	0	0
hs37d5	26199606	T	-C	73	17	18.89%	T	20	12	37.5%	*/-C	Somatic	1.0	0.0324625356947984	1	19	1	11	12	61	7	10
