chrom	position	ref	var	normal_reads1	normal_reads2	normal_var_freq	normal_gt	tumor_reads1	tumor_reads2	tumor_var_freq	tumor_gt	somatic_status	variant_p_value	somatic_p_value	tumor_reads1_plus	tumor_reads1_minus	tumor_reads2_plus	tumor_reads2_minus	normal_reads1_plus	normal_reads1_minus	normal_reads2_plus	normal_reads2_minus
1	1362786	T	C	9	0	0%	T	9	5	35.71%	Y	Somatic	1.0	0.0594965675057212	3	6	1	4	0	9	0	0
1	11168529	A	G	67	0	0%	A	17	5	22.73%	R	Somatic	1.0	0.000634437388662083	4	13	0	5	0	67	0	0
1	11171380	T	A	104	1	0.95%	T	14	5	26.32%	W	Somatic	1.0	0.0002794936410933464	1	13	0	5	2	102	1	0
1	11171412	T	C	53	0	0%	T	7	2	22.22%	Y	Somatic	1.0	0.0190375462718137	4	3	1	1	6	47	0	0
1	17237692	T	C	11	0	0%	T	7	2	22.22%	Y	Somatic	1.0	0.1894736842105263	3	4	0	2	1	10	0	0
1	30126345	G	A	8	0	0%	G	8	2	20%	R	Somatic	1.0	0.2941176470588277	4	4	2	0	6	2	0	0
1	31904679	T	G	8	0	0%	T	7	2	22.22%	K	Somatic	1.0	0.2647058823529424	5	2	1	1	6	2	0	0
1	37046695	A	G	9	0	0%	A	6	2	25%	R	Somatic	1.0	0.2058823529411773	1	5	2	0	6	3	0	0
1	50541554	A	C	22	0	0%	A	12	5	29.41%	M	Somatic	1.0	0.0107475896949581	4	8	0	5	5	17	0	0
1	50541574	G	A	17	0	0%	G	10	4	28.57%	R	Somatic	1.0	0.0318131256952172	1	9	0	4	2	15	0	0
1	50541602	C	T	16	0	0%	C	5	3	37.5%	Y	Somatic	1.0	0.0276679841897235	0	5	0	3	0	16	0	0
1	174147854	A	G	8	0	0%	A	10	3	23.08%	R	Somatic	1.0	0.2150375939849613	8	2	3	0	8	0	0	0
1	227680892	T	C	223	48	17.71%	T	74	27	26.73%	Y	Somatic	1.0	0.0392361739695538	19	55	18	9	38	185	38	10
1	227680893	G	A	225	49	17.88%	G	70	28	28.57%	R	Somatic	1.0	0.0197242695238626	19	51	17	11	37	188	39	10
1	227681379	C	T	88	21	19.27%	C	11	8	42.11%	Y	Somatic	1.0	0.0336366106371641	7	4	3	5	66	22	5	16
1	227695855	A	G	295	41	12.2%	A	66	29	30.53%	R	Somatic	1.0	4.7343670803700026e-05	48	18	4	25	221	74	8	33
1	228752373	G	A	9	0	0%	G	3	6	66.67%	R	Somatic	1.0	0.004524886877828	2	1	5	1	8	1	0	0
1	237872231	A	G	73	0	0%	A	14	10	41.67%	R	Somatic	1.0	1.5594646530302337e-07	14	0	10	0	73	0	0	0
1	237872234	C	G	85	0	0%	C	15	10	40%	S	Somatic	1.0	6.969988757021179e-08	15	0	10	0	85	0	0	0
1	244142899	T	G	9	0	0%	T	8	3	27.27%	K	Somatic	1.0	0.1447368421052647	6	2	3	0	5	4	0	0
1	244142965	T	G	21	0	0%	T	8	2	20%	K	Somatic	1.0	0.0967741935483852	4	4	1	1	11	10	0	0
1	245017982	C	T	19	0	0%	C	10	14	58.33%	Y	Somatic	1.0	2.50227355784235e-05	3	7	7	7	0	19	0	0
2	87575890	T	C	7	1	12.5%	T	3	9	75%	C	Somatic	1.0	0.0098833055489402	2	1	5	4	6	1	0	1
2	87576192	T	C	40	5	11.11%	T	31	21	40.38%	Y	Somatic	1.0	0.000999551939813121	19	12	16	5	14	26	2	3
2	87576214	T	G	40	5	11.11%	T	29	22	43.14%	K	Somatic	1.0	0.0004199956295012874	9	20	15	7	13	27	3	2
2	87576230	T	C	29	4	12.12%	T	21	23	52.27%	Y	Somatic	1.0	0.0002115547811117056	9	12	13	10	10	19	2	2
2	87576290	A	G	11	0	0%	A	2	10	83.33%	R	Somatic	1.0	5.768897948195288e-05	1	1	4	6	4	7	0	0
2	87576296	G	C	10	0	0%	G	5	5	50%	S	Somatic	1.0	0.0162538699690402	1	4	2	3	4	6	0	0
2	97458296	C	T	14	0	0%	C	6	2	25%	Y	Somatic	1.0	0.1212121212121225	0	6	0	2	0	14	0	0
2	130888503	A	G	13	0	0%	A	10	3	23.08%	R	Somatic	1.0	0.1100000000000015	6	4	1	2	8	5	0	0
2	137290687	T	A	11	1	8.33%	T	9	12	57.14%	W	Somatic	1.0	0.0065088423530168	6	3	3	9	4	7	0	1
2	149807136	C	A	57	0	0%	C	8	2	20%	M	Somatic	1.0	0.0203527815468114	0	8	0	2	0	57	0	0
3	12636606	A	G	13	0	0%	A	8	2	20%	R	Somatic	1.0	0.1778656126482181	3	5	1	1	7	6	0	0
3	12636609	G	C	13	0	0%	G	8	2	20%	S	Somatic	1.0	0.1778656126482181	3	5	1	1	7	6	0	0
3	13362410	T	A	7	0	0%	T	6	2	25%	W	Somatic	1.0	0.2666666666666675	4	2	2	0	7	0	0	0
3	106280278	G	A	15	0	0%	G	8	2	20%	R	Somatic	1.0	0.1499999999999986	3	5	1	1	6	9	0	0
3	145733252	T	C	10	0	0%	T	5	3	37.5%	Y	Somatic	1.0	0.0686274509803926	5	0	1	2	10	0	0	0
3	178942119	G	A	54	0	0%	G	23	8	25.81%	R	Somatic	1.0	0.0001639232228115122	0	23	0	8	0	54	0	0
3	178956018	A	G	631	98	13.44%	A	244	68	21.79%	R	Somatic	1.0	0.0006539276997885147	107	137	20	48	244	387	17	81
4	4217151	T	G	10	0	0%	T	20	6	23.08%	K	Somatic	1.0	0.1182005060088544	10	10	1	5	1	9	0	0
4	8635075	C	A	10	0	0%	C	10	3	23.08%	M	Somatic	1.0	0.1614906832298124	3	7	1	2	8	2	0	0
4	8635116	C	T	11	0	0%	C	7	3	30%	Y	Somatic	1.0	0.0902255639097742	3	4	0	3	3	8	0	0
5	1441994	G	T	32	0	0%	G	12	3	20%	K	Somatic	1.0	0.0280604378661738	3	9	3	0	7	25	0	0
5	178654667	G	A	15	0	0%	G	7	2	22.22%	R	Somatic	1.0	0.1304347826086963	3	4	1	1	10	5	0	0
5	178796348	C	T	8	0	0%	C	9	3	25%	Y	Somatic	1.0	0.1929824561403541	1	8	0	3	1	7	0	0
6	28108623	A	G	9	0	0%	A	8	2	20%	R	Somatic	1.0	0.2631578947368443	8	0	2	0	7	2	0	0
6	58778929	T	G	8	0	0%	T	16	4	20%	K	Somatic	1.0	0.2366300366300355	8	8	2	2	1	7	0	0
6	143549031	C	A	31	0	0%	C	7	2	22.22%	M	Somatic	1.0	0.0461538461538469	1	6	0	2	1	30	0	0
7	33734388	T	C	17	0	0%	T	13	4	23.53%	Y	Somatic	1.0	0.0513196480938408	8	5	3	1	11	6	0	0
7	67888053	T	A	35	0	0%	T	7	2	22.22%	W	Somatic	1.0	0.0380549682875257	7	0	2	0	34	1	0	0
7	156855270	C	A	14	0	0%	C	7	2	22.22%	M	Somatic	1.0	0.1422924901185766	2	5	0	2	3	11	0	0
8	11297495	C	A	14	0	0%	C	6	2	25%	M	Somatic	1.0	0.1212121212121225	4	2	1	1	8	6	0	0
8	42878729	A	G	8	0	0%	A	8	3	27.27%	R	Somatic	1.0	0.1702786377708978	0	8	0	3	0	8	0	0
8	43794020	T	G	8	0	0%	T	16	5	23.81%	K	Somatic	1.0	0.1713527851458888	3	13	3	2	1	7	0	0
9	15126734	A	G	8	0	0%	A	7	3	30%	R	Somatic	1.0	0.1470588235294125	6	1	2	1	8	0	0	0
9	44797278	T	C	12	0	0%	T	8	2	20%	Y	Somatic	1.0	0.1948051948051969	7	1	2	0	10	2	0	0
9	44797280	A	G	12	0	0%	A	8	2	20%	R	Somatic	1.0	0.1948051948051969	7	1	2	0	10	2	0	0
9	67340125	G	C	10	0	0%	G	6	5	45.45%	S	Somatic	1.0	0.0227038183694534	6	0	1	4	5	5	0	0
9	101471180	G	C	9	0	0%	G	5	2	28.57%	S	Somatic	1.0	0.1750000000000013	5	0	1	1	9	0	0	0
9	130504797	C	T	8	0	0%	C	8	2	20%	Y	Somatic	1.0	0.2941176470588277	5	3	1	1	8	0	0	0
9	131010436	C	T	100	0	0%	C	15	4	21.05%	Y	Somatic	1.0	0.0004881150410081087	0	15	0	4	5	95	0	0
9	139053643	A	G	26	0	0%	A	13	5	27.78%	R	Somatic	1.0	0.0078894446449751	2	11	0	5	6	20	0	0
9	139053652	A	T	25	0	0%	A	11	5	31.25%	W	Somatic	1.0	0.0058286784859312	1	10	0	5	6	19	0	0
9	139053655	T	C	25	0	0%	T	11	4	26.67%	Y	Somatic	1.0	0.0149359886201994	1	10	0	4	5	20	0	0
9	139053662	A	T	23	0	0%	A	11	3	21.43%	W	Somatic	1.0	0.0468468468468458	1	10	0	3	4	19	0	0
9	140249887	T	A	15	0	0%	T	6	2	25%	W	Somatic	1.0	0.1106719367588929	5	1	1	1	9	6	0	0
10	13179258	G	A	11	0	0%	G	8	2	20%	R	Somatic	1.0	0.2142857142857145	3	5	2	0	10	1	0	0
10	16871311	C	A	12	0	0%	C	8	2	20%	M	Somatic	1.0	0.1948051948051969	0	8	0	2	0	12	0	0
10	22006829	C	T	14	0	0%	C	13	5	27.78%	Y	Somatic	1.0	0.0425472747497227	8	5	2	3	5	9	0	0
10	30647940	G	A	279	1	0.36%	G	86	23	21.1%	R	Somatic	1.0	5.80579211125845e-13	24	62	6	17	38	241	0	1
10	30647945	T	C	270	2	0.74%	T	80	25	23.81%	Y	Somatic	1.0	2.850402877740511e-13	20	60	5	20	29	241	0	2
10	30648009	T	C	85	0	0%	T	10	3	23.08%	Y	Somatic	1.0	0.0018803913317903	0	10	0	3	0	85	0	0
10	86712335	T	A	12	0	0%	T	8	2	20%	W	Somatic	1.0	0.1948051948051969	1	7	1	1	1	11	0	0
10	88561494	G	A	8	0	0%	G	8	2	20%	R	Somatic	1.0	0.2941176470588277	5	3	0	2	1	7	0	0
10	125207211	G	A	9	1	10%	G	4	7	63.64%	R	Somatic	1.0	0.0170278637770899	4	0	7	0	9	0	1	0
10	134588648	G	T	7	0	0%	G	8	4	33.33%	K	Somatic	1.0	0.1277089783281744	5	3	1	3	0	7	0	0
11	36331551	A	T	9	0	0%	A	10	3	23.08%	W	Somatic	1.0	0.1857142857142844	9	1	0	3	3	6	0	0
11	71062472	A	C	23	0	0%	A	8	2	20%	M	Somatic	1.0	0.0852272727272713	6	2	2	0	21	2	0	0
11	94165470	G	A	15	3	16.67%	G	2	8	80%	A	Somatic	1.0	0.0017820470909715	0	2	2	6	8	7	1	2
11	116609257	T	G	11	0	0%	T	8	2	20%	K	Somatic	1.0	0.2142857142857145	4	4	0	2	10	1	0	0
11	134501603	A	G	8	0	0%	A	6	2	25%	R	Somatic	1.0	0.2333333333333349	1	5	0	2	3	5	0	0
12	2681701	T	C	8	0	0%	T	7	2	22.22%	Y	Somatic	1.0	0.2647058823529424	3	4	0	2	4	4	0	0
12	109226004	C	T	13	0	0%	C	7	3	30%	Y	Somatic	1.0	0.0677583286278935	7	0	3	0	12	1	0	0
12	109226005	A	G	13	0	0%	A	8	2	20%	R	Somatic	1.0	0.1778656126482181	8	0	2	0	12	1	0	0
12	113227634	T	A	8	0	0%	T	7	2	22.22%	W	Somatic	1.0	0.2647058823529424	6	1	1	1	1	7	0	0
12	113227646	G	C	8	0	0%	G	5	2	28.57%	S	Somatic	1.0	0.1999999999999994	4	1	1	1	1	7	0	0
12	132316770	A	G	14	0	0%	A	5	2	28.57%	R	Somatic	1.0	0.1000000000000009	2	3	2	0	8	6	0	0
13	93020336	G	C	13	0	0%	G	8	2	20%	S	Somatic	1.0	0.1778656126482181	2	6	0	2	1	12	0	0
14	19626420	G	A	21	3	12.5%	G	9	13	59.09%	R	Somatic	1.0	0.0011086324646422	4	5	9	4	8	13	1	2
14	19720608	G	A	9	0	0%	G	6	3	33.33%	R	Somatic	1.0	0.1029411764705892	6	0	3	0	8	1	0	0
14	23535344	C	G	8	0	0%	C	6	2	25%	S	Somatic	1.0	0.2333333333333349	4	2	2	0	5	3	0	0
14	100061186	G	A	19	0	0%	G	8	2	20%	R	Somatic	1.0	0.1108374384236454	8	0	2	0	18	1	0	0
14	102450100	C	T	40	0	0%	C	8	2	20%	Y	Somatic	1.0	0.0367346938775506	0	8	0	2	0	40	0	0
14	102450105	T	C	50	0	0%	T	8	3	27.27%	Y	Somatic	1.0	0.0045846068352318	0	8	0	3	0	50	0	0
14	102467113	A	G	99	0	0%	A	7	2	22.22%	R	Somatic	1.0	0.0062305295950154	7	0	2	0	99	0	0	0
14	102473197	G	A	185	1	0.54%	G	19	5	20.83%	R	Somatic	1.0	7.254150604475598e-05	19	0	5	0	184	1	1	0
14	102506251	T	C	24	0	0%	T	6	2	25%	Y	Somatic	1.0	0.0564516129032251	1	5	0	2	0	24	0	0
15	20353363	A	G	27	1	3.57%	A	31	12	27.91%	R	Somatic	1.0	0.008021031108284	17	14	7	5	14	13	0	1
15	20353379	A	C	31	2	6.06%	A	39	18	31.58%	M	Somatic	1.0	0.003650057177122	19	20	8	10	16	15	1	1
15	20353407	A	G	33	1	2.94%	A	37	17	31.48%	R	Somatic	1.0	0.0007029551337892605	18	19	6	11	16	17	0	1
15	20353423	A	C	34	1	2.86%	A	40	14	25.93%	M	Somatic	1.0	0.0032031596230708	19	21	8	6	15	19	1	0
15	20353425	A	G	33	1	2.94%	A	43	11	20.37%	R	Somatic	1.0	0.0175174116216571	21	22	4	7	16	17	0	1
15	20353451	A	G	32	0	0%	A	36	19	34.55%	R	Somatic	1.0	4.015899771235425e-05	16	20	9	10	14	18	0	0
15	30442853	G	A	220	27	10.93%	G	88	26	22.81%	R	Somatic	1.0	0.0031018391372904	45	43	20	6	123	97	16	11
15	30442870	A	C	287	25	8.01%	A	117	30	20.41%	M	Somatic	1.0	0.00019162731388940127	80	37	22	8	178	109	15	10
15	30442932	C	T	484	88	15.38%	C	191	75	28.2%	Y	Somatic	1.0	1.459494679160511e-05	119	72	40	35	359	125	48	40
15	32679823	G	A	475	90	15.93%	G	185	75	28.85%	R	Somatic	1.0	1.8136741713367337e-05	58	127	34	41	97	378	44	46
15	32679885	T	G	187	20	9.66%	T	82	25	23.36%	K	Somatic	1.0	0.0011628393539915	26	56	5	20	52	135	8	12
15	32679932	A	C	92	4	4.17%	A	97	25	20.49%	M	Somatic	1.0	0.0002465503937723763	62	35	19	6	51	41	0	4
15	32730569	A	C	84	14	14.29%	A	68	23	25.27%	M	Somatic	1.0	0.0426119082995585	42	26	12	11	41	43	9	5
15	34149808	C	T	81	0	0%	C	9	10	52.63%	Y	Somatic	1.0	5.336588593776714e-09	9	0	10	0	77	4	0	0
15	49269533	G	A	13	0	0%	G	11	3	21.43%	R	Somatic	1.0	0.1244444444444423	1	10	0	3	1	12	0	0
15	76033448	T	C	76	0	0%	T	13	4	23.53%	Y	Somatic	1.0	0.0008151424701213584	0	13	0	4	7	69	0	0
15	82733410	A	G	408	63	13.38%	A	135	40	22.86%	R	Somatic	1.0	0.0031051559784947	57	78	33	7	190	218	61	2
15	82733430	G	C	376	72	16.07%	G	131	44	25.14%	S	Somatic	1.0	0.0070449849018074	47	84	30	14	163	213	61	11
15	82733459	T	C	327	78	19.26%	T	128	46	26.44%	Y	Somatic	1.0	0.0356805456664817	53	75	22	24	123	204	58	20
15	82767119	C	T	130	15	10.34%	C	47	13	21.67%	Y	Somatic	1.0	0.0300131569162089	43	4	13	0	112	18	8	7
15	83109935	A	G	376	67	15.12%	A	133	39	22.67%	R	Somatic	1.0	0.0190614998954289	68	65	36	3	180	196	64	3
15	83109955	G	C	367	76	17.16%	G	129	41	24.12%	S	Somatic	1.0	0.0338409300576177	63	66	33	8	164	203	69	7
15	85048126	C	T	234	34	12.69%	C	93	27	22.5%	Y	Somatic	1.0	0.0118967076208407	87	6	24	3	210	24	34	0
15	102292708	T	C	127	14	9.93%	T	70	23	24.73%	Y	Somatic	1.0	0.0023532091832582	47	23	15	8	72	55	11	3
15	102292726	G	A	132	31	19.02%	G	79	33	29.46%	R	Somatic	1.0	0.0313833231454582	54	25	21	12	72	60	26	5
15	102292900	T	C	103	5	4.63%	T	55	16	22.54%	Y	Somatic	1.0	0.0003556830308254285	35	20	8	8	33	70	2	3
16	2105689	C	T	91	0	0%	C	5	2	28.57%	Y	Somatic	1.0	0.0044182621502202	0	5	0	2	0	91	0	0
16	2115298	T	C	36	1	2.7%	T	8	3	27.27%	Y	Somatic	1.0	0.0330712303422742	8	0	3	0	36	0	1	0
16	20261564	A	G	11	0	0%	A	6	2	25%	R	Somatic	1.0	0.1637426900584798	6	0	2	0	11	0	0	0
16	20261571	A	G	12	0	0%	A	7	2	22.22%	R	Somatic	1.0	0.1714285714285741	7	0	2	0	12	0	0	0
16	30014097	G	T	14	0	0%	G	8	2	20%	K	Somatic	1.0	0.1630434782608678	6	2	2	0	12	2	0	0
16	46394622	A	T	15	3	16.67%	A	87	69	44.23%	W	Somatic	1.0	0.0196439050154715	39	48	35	34	2	13	0	3
16	90161591	C	T	29	6	17.14%	C	3	5	62.5%	Y	Somatic	1.0	0.0174568854450635	2	1	5	0	25	4	5	1
16	90161651	C	T	118	9	7.09%	C	27	8	22.86%	Y	Somatic	1.0	0.0123501304076011	17	10	3	5	111	7	3	6
17	21903195	G	C	7	0	0%	G	3	6	66.67%	S	Somatic	1.0	0.0104895104895105	2	1	6	0	5	2	0	0
17	43515018	C	G	16	0	0%	C	8	2	20%	S	Somatic	1.0	0.1384615384615365	4	4	0	2	13	3	0	0
17	45523401	G	C	12	0	0%	G	7	3	30%	S	Somatic	1.0	0.0779220779220775	5	2	1	2	7	5	0	0
17	80039340	A	C	138	0	0%	A	12	3	20%	M	Somatic	1.0	0.000777410999254849	2	10	2	1	35	103	0	0
17	80544378	G	T	38	7	15.56%	G	11	8	42.11%	K	Somatic	1.0	0.0270010104235519	4	7	1	7	5	33	1	6
18	25757243	C	A	8	0	0%	C	6	2	25%	M	Somatic	1.0	0.2333333333333349	3	3	1	1	6	2	0	0
18	48530956	G	C	8	0	0%	G	6	2	25%	S	Somatic	1.0	0.2333333333333349	3	3	0	2	5	3	0	0
18	48530964	A	G	8	0	0%	A	6	2	25%	R	Somatic	1.0	0.2333333333333349	4	2	0	2	5	3	0	0
18	56010509	G	A	9	0	0%	G	2	6	75%	A	Somatic	1.0	0.002262443438914	0	2	0	6	0	9	0	0
18	56066876	C	T	111	0	0%	C	8	2	20%	Y	Somatic	1.0	0.006198347107438	3	5	1	1	55	56	0	0
19	487036	A	G	15	0	0%	A	8	2	20%	R	Somatic	1.0	0.1499999999999986	7	1	2	0	13	2	0	0
19	487039	G	A	18	0	0%	G	8	2	20%	R	Somatic	1.0	0.11904761904762	7	1	2	0	16	2	0	0
19	13409187	T	C	58	0	0%	T	6	4	40%	Y	Somatic	1.0	0.0002578632956157179	5	1	4	0	58	0	0	0
19	16888833	G	T	22	0	0%	G	7	2	22.22%	K	Somatic	1.0	0.0774193548387093	3	4	2	0	13	9	0	0
19	17578703	A	G	14	0	0%	A	6	2	25%	R	Somatic	1.0	0.1212121212121225	2	4	1	1	5	9	0	0
19	18280849	C	T	89	0	0%	C	8	2	20%	Y	Somatic	1.0	0.0092764378478664	0	8	1	1	4	85	0	0
19	18280943	A	G	96	19	16.52%	A	33	17	34%	R	Somatic	1.0	0.0122856347493756	33	0	17	0	90	6	19	0
19	18281102	G	A	888	125	12.34%	G	135	50	27.03%	R	Somatic	1.0	9.723905206774651e-07	69	66	16	34	573	315	55	70
19	18281151	G	T	1031	120	10.43%	G	157	48	23.41%	K	Somatic	1.0	1.1292412748827298e-06	77	80	24	24	534	497	47	73
19	21420895	T	A	9	0	0%	T	7	2	22.22%	W	Somatic	1.0	0.235294117647059	0	7	1	1	0	9	0	0
19	21420904	C	T	9	0	0%	C	8	2	20%	Y	Somatic	1.0	0.2631578947368443	1	7	0	2	0	9	0	0
19	36002405	T	C	5	0	0%	T	6	2	25%	Y	Somatic	1.0	0.3589743589743588	1	5	1	1	1	4	0	0
19	47710944	A	G	9	0	0%	A	10	4	28.57%	R	Somatic	1.0	0.1130434782608708	3	7	0	4	2	7	0	0
20	993475	C	G	9	0	0%	C	8	2	20%	S	Somatic	1.0	0.2631578947368443	7	1	1	1	9	0	0	0
20	993483	T	A	9	0	0%	T	8	2	20%	W	Somatic	1.0	0.2631578947368443	7	1	1	1	6	3	0	0
20	17867405	C	A	13	0	0%	C	6	2	25%	M	Somatic	1.0	0.1333333333333354	2	4	1	1	5	8	0	0
20	41724741	T	C	14	3	17.65%	T	3	6	66.67%	Y	Somatic	1.0	0.0198972652061896	1	2	1	5	13	1	0	3
20	60794366	A	C	29	0	0%	A	5	2	28.57%	M	Somatic	1.0	0.0333333333333327	5	0	2	0	18	11	0	0
21	40286348	A	G	19	0	0%	A	8	2	20%	R	Somatic	1.0	0.1108374384236454	7	1	0	2	18	1	0	0
21	40746912	A	G	20	0	0%	A	15	11	42.31%	R	Somatic	1.0	0.000579138412377217	3	12	2	9	7	13	0	0
21	40746928	G	A	18	0	0%	G	13	4	23.53%	R	Somatic	1.0	0.0454545454545469	3	10	0	4	6	12	0	0
21	40746935	T	C	20	0	0%	T	12	3	20%	Y	Somatic	1.0	0.0695187165775397	1	11	0	3	5	15	0	0
21	40746936	G	A	20	0	0%	G	11	3	21.43%	R	Somatic	1.0	0.0608288770053457	1	10	0	3	5	15	0	0
21	40746947	G	A	16	0	0%	G	8	2	20%	R	Somatic	1.0	0.1384615384615365	0	8	0	2	0	16	0	0
21	44812186	C	T	10	0	0%	C	6	2	25%	Y	Somatic	1.0	0.1830065359477151	0	6	0	2	1	9	0	0
22	18326889	A	G	16	0	0%	A	11	3	21.43%	R	Somatic	1.0	0.0896551724137934	9	2	3	0	14	2	0	0
22	18326893	G	T	17	0	0%	G	11	3	21.43%	K	Somatic	1.0	0.0809788654060054	9	2	2	1	14	3	0	0
22	32194795	A	T	132	0	0%	A	13	4	23.53%	W	Somatic	1.0	0.00012068964905224924	0	13	0	4	1	131	0	0
22	32269986	T	C	77	1	1.28%	T	19	6	24%	Y	Somatic	1.0	0.0007214524799861839	19	0	6	0	76	1	1	0
22	35757961	A	G	22	0	0%	A	8	4	33.33%	R	Somatic	1.0	0.0106736242884249	7	1	4	0	22	0	0	0
22	46690019	C	G	12	0	0%	C	9	3	25%	S	Somatic	1.0	0.1086956521739108	0	9	0	3	0	12	0	0
22	46690033	T	C	11	0	0%	T	6	2	25%	Y	Somatic	1.0	0.1637426900584798	0	6	0	2	0	11	0	0
X	197041	A	C	14	0	0%	A	7	2	22.22%	M	Somatic	1.0	0.1422924901185766	3	4	1	1	6	8	0	0
X	319606	G	A	9	1	10%	G	4	6	60%	R	Somatic	1.0	0.0286377708978327	3	1	3	3	6	3	0	1
X	319607	C	A	9	1	10%	C	4	6	60%	M	Somatic	1.0	0.0286377708978327	3	1	3	3	6	3	0	1
X	53277149	T	G	99	0	0%	T	15	4	21.05%	K	Somatic	1.0	0.0005050929554780072	15	0	0	4	97	2	0	0
Y	27569480	T	A	270	9	3.23%	T	197	50	20.24%	W	Somatic	1.0	2.3019902419773044e-10	129	68	20	30	175	95	3	6
Y	58826366	T	G	9	0	0%	T	22	9	29.03%	K	Somatic	1.0	0.073727902191525	13	9	3	6	4	5	0	0
Y	58832137	G	C	9	0	0%	G	41	12	22.64%	S	Somatic	1.0	0.1235019558808323	16	25	4	8	4	5	0	0
Y	58869645	C	G	9	0	0%	C	48	13	21.31%	S	Somatic	1.0	0.138335758095915	23	25	9	4	5	4	0	0
Y	58892738	C	T	8	0	0%	C	38	12	24%	Y	Somatic	1.0	0.1361295810999817	20	18	6	6	4	4	0	0
Y	58913571	G	T	8	0	0%	G	64	18	21.95%	K	Somatic	1.0	0.1544079962751259	29	35	10	8	2	6	0	0
GL000214.1	64679	G	A	10	0	0%	G	8	2	20%	R	Somatic	1.0	0.2368421052631576	5	3	1	1	6	4	0	0
GL000220.1	112857	C	G	12	0	0%	C	13	5	27.78%	S	Somatic	1.0	0.0601237842617153	1	12	0	5	2	10	0	0
GL000220.1	124002	G	T	70	4	5.41%	G	60	15	20%	K	Somatic	1.0	0.0067436585211108	23	37	10	5	38	32	1	3
GL000220.1	132638	G	C	64	8	11.11%	G	173	51	22.77%	S	Somatic	1.0	0.0200751705233316	89	84	20	31	38	26	6	2
GL000220.1	140832	T	C	17	2	10.53%	T	52	26	33.33%	Y	Somatic	1.0	0.0398600629811225	23	29	13	13	8	9	1	1
GL000220.1	156871	G	A	9	0	0%	G	8	2	20%	R	Somatic	1.0	0.2631578947368443	3	5	1	1	0	9	0	0
GL000199.1	34503	A	T	19	1	5%	A	212	62	22.63%	W	Somatic	1.0	0.0463703977786574	77	135	21	41	3	16	1	0
GL000219.1	158923	C	A	20	2	9.09%	C	14	9	39.13%	M	Somatic	1.0	0.021209830625599	11	3	6	3	15	5	2	0
hs37d5	455536	C	T	143	29	16.86%	C	61	25	29.07%	Y	Somatic	1.0	0.0186158863966178	32	29	16	9	70	73	17	12
hs37d5	1004520	C	A	18	0	0%	C	70	22	23.91%	M	Somatic	1.0	0.0121267829106388	13	57	6	16	0	18	0	0
hs37d5	1443648	C	T	15	1	6.25%	C	115	59	33.91%	Y	Somatic	1.0	0.0157751649298924	45	70	34	25	5	10	0	1
hs37d5	2948383	A	C	8	0	0%	A	32	9	21.95%	M	Somatic	1.0	0.1705286593694334	29	3	7	2	8	0	0	0
hs37d5	7233733	T	C	8	0	0%	T	6	2	25%	Y	Somatic	1.0	0.2333333333333349	3	3	1	1	4	4	0	0
hs37d5	8165922	G	C	21	0	0%	G	13	4	23.53%	S	Somatic	1.0	0.0322427690848743	9	4	3	1	17	4	0	0
hs37d5	8166362	G	C	18	3	14.29%	G	7	8	53.33%	S	Somatic	1.0	0.0161017688499203	5	2	7	1	14	4	2	1
hs37d5	8166411	A	C	19	4	17.39%	A	8	10	55.56%	M	Somatic	1.0	0.0127336057129324	5	3	7	3	8	11	2	2
hs37d5	8261629	A	G	8	0	0%	A	8	2	20%	R	Somatic	1.0	0.2941176470588277	2	6	2	0	5	3	0	0
hs37d5	15695918	C	T	13	3	18.75%	C	4	6	60%	Y	Somatic	1.0	0.0424797170792596	2	2	4	2	6	7	3	0
hs37d5	16608278	C	T	8	0	0%	C	123	59	32.42%	Y	Somatic	1.0	0.0476817126169198	64	59	37	22	4	4	0	0
hs37d5	19373561	T	G	11	0	0%	T	93	28	23.14%	K	Somatic	1.0	0.0644449128259255	15	78	5	23	1	10	0	0
hs37d5	19940766	A	C	34	4	10.53%	A	179	62	25.73%	M	Somatic	1.0	0.0266525433198738	115	64	51	11	27	7	4	0
hs37d5	20895305	T	C	16	0	0%	T	136	45	24.86%	Y	Somatic	1.0	0.013021351693533	79	57	33	12	8	8	0	0
hs37d5	21479397	G	T	8	0	0%	G	92	27	22.69%	K	Somatic	1.0	0.1388356897756422	14	78	6	21	1	7	0	0
hs37d5	22568620	G	A	10	0	0%	G	122	32	20.78%	R	Somatic	1.0	0.1064380351613556	69	53	16	16	4	6	0	0
hs37d5	24071196	G	A	13	2	13.33%	G	30	20	40%	R	Somatic	1.0	0.0497896885218379	29	1	18	2	13	0	2	0
hs37d5	24071225	A	T	29	6	17.14%	A	202	120	37.27%	W	Somatic	1.0	0.0118153631569943	182	20	112	8	28	1	6	0
hs37d5	26917884	G	T	7	0	0%	G	55	19	25.68%	K	Somatic	1.0	0.1414338560330086	31	24	10	9	5	2	0	0
hs37d5	27068124	A	C	12	0	0%	A	18	5	21.74%	M	Somatic	1.0	0.1036527514231489	18	0	5	0	12	0	0	0
hs37d5	27395916	T	G	19	0	0%	T	15	5	25%	K	Somatic	1.0	0.0269280269280264	3	12	0	5	0	19	0	0
hs37d5	27395929	T	C	13	1	7.14%	T	11	8	42.11%	Y	Somatic	1.0	0.029831799642701	2	9	0	8	0	13	0	1
hs37d5	27406389	T	G	11	0	0%	T	57	16	21.92%	K	Somatic	1.0	0.0825370761138059	21	36	7	9	6	5	0	0
hs37d5	27905317	A	T	8	0	0%	A	108	29	21.17%	W	Somatic	1.0	0.1595524207636514	18	90	7	22	0	8	0	0
hs37d5	27951150	A	T	13	0	0%	A	82	28	25.45%	W	Somatic	1.0	0.0284149115544258	41	41	22	6	7	6	0	0
hs37d5	27951267	T	A	8	0	0%	T	48	17	26.15%	W	Somatic	1.0	0.1056748069332155	22	26	3	14	1	7	0	0
hs37d5	28310269	A	G	20	4	16.67%	A	115	64	35.75%	R	Somatic	1.0	0.0468642155028443	93	22	58	6	19	1	4	0
hs37d5	28890971	C	A	12	0	0%	C	7	2	22.22%	M	Somatic	1.0	0.1714285714285741	5	2	2	0	8	4	0	0
hs37d5	29868172	A	G	10	0	0%	A	77	36	31.86%	R	Somatic	1.0	0.0266684325400224	59	18	30	6	9	1	0	0
1	9300861	G	-C	11	0	0%	G	7	2	22.22%	*/-C	Somatic	1.0	0.1894736842105263	5	2	1	1	3	8	0	0
1	147554890	A	-CT	17	1	5.56%	A	17	8	32%	*/-CT	Somatic	1.0	0.0381459230012829	5	12	1	7	2	15	0	1
1	240097066	G	-AA	10	0	0%	G	37	11	22.92%	*/-AA	Somatic	1.0	0.0992356864671721	25	12	4	7	8	2	0	0
1	245017464	T	-A	550	87	13.66%	T	178	48	21.24%	*/-A	Somatic	1.0	0.0056338873346878	97	81	25	23	343	207	48	39
2	1562043	C	-T	8	0	0%	C	9	3	25%	*/-T	Somatic	1.0	0.1929824561403541	2	7	0	3	1	7	0	0
2	91780442	T	-C	11	0	0%	T	11	4	26.67%	*/-C	Somatic	1.0	0.0913043478260877	7	4	1	3	6	5	0	0
2	149855345	C	-A	112	15	11.81%	C	29	12	29.27%	*/-A	Somatic	1.0	0.010455339305217	23	6	3	9	23	89	2	13
2	166892444	T	-AAA	55	12	17.91%	T	14	9	39.13%	*/-AAA	Somatic	1.0	0.039851513381174	14	0	8	1	55	0	0	0
3	106280284	C	-AG	15	0	0%	C	8	2	20%	*/-AG	Somatic	1.0	0.1499999999999986	4	4	0	2	5	10	0	0
3	178952910	T	-A	300	54	15.25%	T	130	48	26.97%	*/-A	Somatic	1.0	0.0010691772103209	70	60	24	24	159	141	26	28
5	5954914	C	+T	8	0	0%	C	7	2	22.22%	*/+T	Somatic	1.0	0.2647058823529424	2	5	1	1	4	4	0	0
6	168854507	C	-GTCTCTCTGTTT	22	0	0%	C	8	2	20%	*/-GTCTCTCTGTTT	Somatic	1.0	0.0907258064516143	1	7	0	2	1	21	0	0
8	8257409	C	-TCTT	8	0	0%	C	9	3	25%	*/-TCTT	Somatic	1.0	0.1929824561403541	9	0	3	0	6	2	0	0
9	15126842	A	-CGG	8	0	0%	A	5	4	44.44%	*/-CGG	Somatic	1.0	0.0529411764705883	3	2	1	3	2	6	0	0
9	15126869	G	+AGC	7	0	0%	G	6	2	25%	*/+AGC	Somatic	1.0	0.2666666666666675	3	3	0	2	2	5	0	0
9	84107285	C	-A	9	0	0%	C	5	4	44.44%	*/-A	Somatic	1.0	0.0411764705882359	4	1	2	2	6	3	0	0
11	125904433	T	-A	16	0	0%	T	6	2	25%	*/-A	Somatic	1.0	0.1014492753623192	2	4	1	1	5	11	0	0
12	117175434	G	+A	8	0	0%	G	8	2	20%	*/+A	Somatic	1.0	0.2941176470588277	5	3	2	0	7	1	0	0
13	37477263	G	-T	10	0	0%	G	6	5	45.45%	*/-T	Somatic	1.0	0.0227038183694534	3	3	0	5	0	10	0	0
13	104316132	C	-TCTCTCTG	9	2	18.18%	C	3	13	81.25%	-TCTCTCTG/-TCTCTCTG	Somatic	1.0	0.0018486112980661	2	1	6	7	7	2	2	0
15	79031159	G	-GT	109	0	0%	G	45	19	29.69%	*/-GT	Somatic	1.0	8.875206748931117e-10	10	35	5	14	6	103	0	0
16	19502033	T	-TTCCTTCC	6	0	0%	T	7	8	53.33%	*/-TTCCTTCC	Somatic	1.0	0.0316231755860241	7	0	8	0	5	1	0	0
16	23617563	T	-A	8	0	0%	T	5	2	28.57%	*/-A	Somatic	1.0	0.1999999999999994	2	3	1	1	4	4	0	0
17	79223233	G	+GGAGGGAAGA	6	0	0%	G	11	5	31.25%	*/+GGAGGGAAGA	Somatic	1.0	0.1658692185007993	6	5	3	2	4	2	0	0
18	3159872	T	-TTCCTTCCTTCC	7	0	0%	T	6	3	33.33%	*/-TTCCTTCCTTCC	Somatic	1.0	0.1499999999999997	6	0	3	0	7	0	0	0
19	18280856	T	+A	79	1	1.25%	T	8	2	20%	*/+A	Somatic	1.0	0.0316649642492326	3	5	0	2	5	74	0	1
19	30058517	A	-GCTGGTGTGATGGGCACAGGGGAGGG	12	0	0%	A	7	2	22.22%	*/-GCTGGTGTGATGGGCACAGGGGAGGG	Somatic	1.0	0.1714285714285741	5	2	1	1	5	7	0	0
20	19915611	T	-A	13	0	0%	T	16	5	23.81%	*/-A	Somatic	1.0	0.0731304985337219	7	9	1	4	3	10	0	0
X	197043	G	+C	16	0	0%	G	8	2	20%	*/+C	Somatic	1.0	0.1384615384615365	4	4	1	1	7	9	0	0
X	110543844	C	-T	208	38	15.45%	C	106	32	23.19%	*/-T	Somatic	1.0	0.0414378773923997	64	42	20	12	112	96	16	22
GL000220.1	102580	T	-TTTCTTTTTC	18	1	5.26%	T	60	23	27.71%	*/-TTTCTTTTTC	Somatic	1.0	0.0288180759981249	35	25	13	10	5	13	1	0
GL000224.1	11008	A	-G	12	0	0%	A	7	2	22.22%	*/-G	Somatic	1.0	0.1714285714285741	5	2	1	1	9	3	0	0
hs37d5	18488558	T	-GGAATGGAATGGAATTGAAA	7	0	0%	T	42	17	28.81%	*/-GGAATGGAATGGAATTGAAA	Somatic	1.0	0.1103001396629163	14	28	7	10	5	2	0	0
